阿党比周	a'dang'bi'zhou	相互勾结，相互偏袒，结党营私。
阿平绝倒	a'ping'jue'dao	据《晋书·卫玠传》及《王澄传》载，玠好言玄理。琅玡王澄字平子，兄昵称之曰：“阿平”。有高名，少所推许，每闻玠言，辄叹息绝倒。故时为之语曰：“卫玠谈道，平子绝倒。”后因以“阿平绝倒”谓对对方的言论极为佩服。亦用为讥讽言论极为乖谬，常贻笑大方。
阿权膴仕	a'quan'hu'shi	阿附权势，以求得高位厚禄。
阿时趋俗	a'shi'qu'su	迎合世俗和时尚。
阿世媚俗	a'shi'mei'su	曲意迎合当时社会的陈规陋俗。
阿世取容	a'shi'qu'rong	迎合世俗，取悦于人。
阿意取容	a'yi'qu'rong	曲从其意，以取悦于人。
阿谀取容	a'yu'qu'rong	曲意奉承，取悦于人。
哀兵必胜	ai'bing'bi'sheng	《老子》：“故抗兵相加，哀者胜矣。”王弼注：“抗，举也。加，当也。哀者必相惜，而不趣利避害，故必胜。”任继愈注：“哀，沉痛，悲愤。”后遂谓因受压而悲愤的一方，定能克敌制胜。
哀而不伤	ai'er'bu'shang	谓悲伤而不过分。儒家诗教的重要命题。指诗歌、音乐不失中和之美。《论语·八佾》：“《关雎》乐而不淫，哀而不伤。”何晏集解：“孔曰：‘哀不至伤，言其和也。’”硃熹集注：“伤者，哀之过而害於和者也。”鲁迅《汉文学史纲要》第二篇：“哀而不伤，乐而不淫，虽诗歌，亦教训也。”亦谓貌似悲哀而实不伤心。
哀感顽艳	ai'gan'wan'yan	《文选·繁钦〈与魏文帝笺〉》：“咏北狄之遐征，奏胡马之长思，凄入肝脾，哀感顽艳。”吕延济注：“顽钝艳美者皆感之。”后遂以“哀感顽艳”形容诗文的词旨凄恻动人。
哀鸿遍野	ai'hong'bian'ye	比喻到处都是流离失所的灾民。
哀毁骨立	ai'hui'gu'li	亦作“哀毁瘠立”。形容因居亲丧悲损其身，瘦瘠如骨骸支立。语本《后汉书·韦彪传》：“父母卒，哀毁三年……服竟，羸瘠骨立异形。”
哀毁瘠立	ai'hui'ji'li	见“哀毁骨立”。
哀丝豪竹	ai'si'hao'zhu	指悲壮的乐声。丝，指弦乐器；竹，指管乐器。
唉声叹气	ai'sheng'tan'qi	见“唉声叹气”。
唉声叹气	ai'sheng'tan'qi	亦作“唉声叹气”。因伤感、烦闷或痛苦而发出叹息声。
挨风缉缝	ai'feng'ji'feng	谓多方钻营。
挨肩并足	ai'jian'bing'zu	形容人群拥挤。
挨肩擦膀	ai'jian'ca'bang	谓身体相贴近。
挨肩擦背	ai'jian'ca'bei	形容人群拥挤。
挨肩叠背	ai'jian'die'bei	形容人群拥挤。
挨三顶五	ai'san'ding'wu	又作：三五成群。
挨山塞海	ai'shan'sai'hai	形容人多拥挤。
捱风缉缝	ai'feng'ji'feng	多方钻营。
捱三顶四	ai'san'ding'si	形容人群拥挤，接连不断。
捱三顶五	ai'san'ding'wu	见“捱三顶四”。
嗳声叹气	ai'sheng'tan'qi	因伤感、烦闷或痛苦而发出叹息的声音。
矮人观场	ai'ren'guan'chang	同“矮子看戏”。
矮人看场	ai'ren'kan'chang	同“矮子看戏”。
矮人看戏	ai'ren'kan'xi	见“矮子看戏”。
矮子观场	ai'zi'guan'chang	同“矮子看戏”。
矮子看戏	ai'zi'kan'xi	喻己无所见而随声附和。
爱不忍释	ai'bu'ren'shi	喜欢得舍不得放下。极言喜爱。
爱不释手	ai'bu'shi'shou	见“爱不忍释”。
爱才如命	ai'cai'ru'ming	见“爱才若渴”。
爱才若渴	ai'cai'ruo'ke	爱慕贤才就像口渴思饮一样。形容十分爱重人才。
爱财如命	ai'cai'ru'ming	吝惜钱财就像吝惜自己的生命一样。喻过分贪财，非常吝啬。
爱礼存羊	ai'li'cun'yang	《论语·八佾》：“子贡欲去告朔之饩羊，子曰：‘赐也，尔爱其羊，我爱其礼。’”后以“爱礼存羊”比喻为维护根本而保留有关仪节。
爱莫能助	ai'mo'neng'zhu	虽然同情，却限于条件无从帮助。语本《诗·大雅·烝民》：“我仪图之，维仲山甫举之，爱莫助之。”郑玄笺：“爱，惜也。仲山甫独能举此德而行之，惜乎莫能助之者。”
爱人以德	ai'ren'yi'de	按照道德标准去爱护和帮助他人。
爱手反裘	ai'shou'fan'qiu	比喻愚昧不辨本末。语本汉刘向《新序·杂事二》：“魏文侯出游，见路人反裘而负刍。文侯曰：‘胡为反裘而负刍？’对曰：‘臣爱其毛。’文侯曰：‘若不知其里尽而毛无所恃耶？’”
爱素好古	ai'su'hao'gu	《老子》：“见素抱朴，少私寡欲。”《论语·述而》：“子曰：述而不作，信而好古，窃比於我老彭。”后以“爱素好古”谓爱好朴质，不趋时尚。
爱屋及乌	ai'wu'ji'wu	谓爱其人而推爱及与之有关的人或物。语本《尚书大传》卷三：“爱人者，兼其屋上之乌。”
爱惜羽毛	ai'xi'yu'mao	汉刘向《说苑·杂言》：“夫君子爱口，孔雀爱羽，虎豹爱爪。”后以“爱惜羽毛”喻珍惜自己的名声。
爱憎分明	ai'zeng'fen'ming	爱什么，恨什么，态度很鲜明。
碍手碍脚	ai'shou'ai'jiao	妨碍别人做事，使人感到不方便。
碍足碍手	ai'zu'ai'shou	同“碍手碍脚”。
安邦定国	an'bang'ding'guo	使国家平安稳定。
安不忘危	an'bu'wang'wei	处在平安的环境，要经常想到可能会出现的困难危险。
安步当车	an'bu'dang'che	缓缓步行，当作坐车。语本《战国策·齐策四》：“晚食以当肉，安步以当车。”
安常習故	an'chang'xi'gu	谓习惯于成规。
安堵乐业	an'du'le'ye	同“安居乐业”。
安分守己	an'fen'shou'ji	安守本分，规矩老实。
安份守己	an'fen'shou'ji	见“安分守己”。
安富尊荣	an'fu'zun'rong	安逸富足，尊贵荣耀。
安故重迁	an'gu'zhong'qian	安于旧俗，不轻易改变。
安家乐业	an'jia'le'ye	犹安居乐业。
安家立业	an'jia'li'ye	成立家庭，建立事业。
安家落户	an'jia'luo'hu	①把家庭安置在某地，长期住下去。②比喻某种生物被引进到新地方后，同原产地一样地生长繁殖。
安居乐业	an'ju'le'ye	安定地生活，愉快地从事其职业。
安老怀少	an'lao'huai'shao	尊重老人，使其安逸；关怀年轻人，使其信从。语本《论语·公冶长》：“子路曰：‘原闻子之志。’子曰：‘老者安之，朋友信之，少者怀之。’”邢昺疏：“此夫子之志也。怀，归也，言己原老者安，己事之以孝敬也……少者归，己施之以恩惠也。”
安 乐 窝	an' 'le' 'wo		宋邵雍自号安乐先生，隐居苏门山，名其居为“安乐窝”。后迁洛阳天津桥南仍用此名。曾作《无名公传》自况：“所寝之室谓之安乐窝，不求过美，惟求冬暖夏凉。”又作《安乐窝中四长吟》：“安乐窝中快活人，闲来四物幸相亲：一编诗逸收花月，一部书严惊鬼神，一炷香清冲宇泰，一樽酒美湛天真。”后泛指安静舒适的住处。
安民告示	an'min'gao'shi	安定民心的告示。
安内攘外	an'nei'rang'wai	汉张仲景《伤寒论·太阳病上》：“甘草甘平，有安内攘外之能。”原就药的疗效而言。后多指安定内部，排除外患。
安贫乐道	an'pin'le'dao	谓安于清贫，以追求圣贤之道为乐。为古代儒家所提倡的立身处世的态度。语本《论语·雍也》：“贤哉回也！一箪食，一瓢饮，在陋巷。人不堪其忧，回也不改其乐。”何晏集解引孔安国曰：“颜渊乐道，虽箪食在陋巷，不改其所乐。”
安然无恙	an'ran'wu'yang	平安无事。
安如太山	an'ru'tai'shan	见“安如泰山”。
安如泰山	an'ru'tai'shan	形容极其平安稳固。泰，也写作“太”。
安身乐业	an'shen'le'ye	安稳快乐地过日子。
安身立命	an'shen'li'ming	谓生活有着落，精神亦有所寄托。
安生服业	an'sheng'fu'ye	平稳地生活，安心地从事自己的生业。
安生乐业	an'sheng'le'ye	犹安居乐业。
安时处顺	an'shi'chu'shun	谓安于时运，顺应变化。语本《庄子·养生主》：“適来，夫子时也；適去，夫子顺也。安时而处顺，哀乐不能入也。”
安土乐业	an'tu'le'ye	安居本土，愉快地从事自己的职业。
安土重旧	an'tu'zhong'jiu	留恋故土，不轻易改变旧俗。
安土重居	an'tu'zhong'ju	犹安土重迁。
安土重迁	an'tu'zhong'qian	留恋故乡，不愿轻易迁居异地。
安心乐业	an'xin'le'ye	心绪安定，生活愉快。
安心乐意	an'xin'le'yi	心情安定，满意。
安心落意	an'xin'luo'yi	放心，无忧虑。
安营下寨	an'ying'xia'zhai	见“安营扎寨”。
安营扎寨	an'ying'za'zhai	亦作“安营下寨”。①指军队驻扎。②现喻指为完成某项任务而建立临时住所。
安於盘石	an'yu'pan'shi	象盘石一样安然不动。形容安定稳固。
安於现状	an'yu'xian'zhuang	习惯、满足于目前的状况，不求进取。
安枕而卧	an'zhen'er'wo	安安稳稳地睡眠。喻指无忧无虑。
安之若素	an'zhi'ruo'su	谓对反常现象或不顺利的情况视若平常，毫不在意。
鞍前马后	an'qian'ma'hou	又作：马前马后。谓追随左右。
闇室不欺	an'shi'bu'qi	据汉刘向《列女传·卫灵夫人》载，卫大夫蘧伯玉仁智敬上，夜间乘车过卫灵公阙，按照礼制下公门，式路马，不以闇昧废礼。后因以“闇室不欺”谓在无人看见的地方，也不作昧心事。
闇无天日	an'wu'tian'ri	形容社会极端黑暗。
岸谷之变	an'gu'zhi'bian	《诗·小雅·十月之交》：“高岸为谷，深谷为陵。”毛传：“言易位也。”郑玄笺：“易位者，君子居下小人处上之谓也。”后因以“岸谷之变”比喻政治上的重大变化。
岸然道貌	an'ran'dao'mao	①谓神态严肃。②指严肃的神态。
按兵不动	an'bing'bu'dong	让军队驻扎下来暂不行动。
按步就班	an'bu'jiu'ban	见“按部就班”。
按部就班	an'bu'jiu'ban	①谓安排文义，组织章句。语出晋陆机《文赋》：“观古今於须臾，抚四海於一瞬。然后选义按部，考辞就班。”②按照条理或遵循一定的程序。
按甲寝兵	an'jia'qin'bing	见“按甲休兵”。
按甲休兵	an'jia'xiu'bing	屯兵休整。
按名责实	an'ming'ze'shi	循名责实。
按图索骥	an'tu'suo'ji	亦作“按图索骏”。①按照图像寻找良马。比喻拘泥成法办事。语本《汉书·梅福传》：“今不循伯者之道，乃欲以三代选举之法，取当时之士，犹察伯乐之图，求骐骥於市，而不可得，亦已明矣。”②用于比喻按照线索去寻找，易于获得。
按图索骏	an'tu'suo'jun	见“按图索骥”。
案兵束甲	an'bing'shu'jia	放下兵器，捆束铠甲。谓停止作战。
案甲休兵	an'jia'xiu'bing	谓停止战事，休养士卒。
暗锤打人	an'chui'da'ren	比喻暗中对人进行攻击。
暗斗明争	an'dou'ming'zheng	暗里明里都在进行斗争。常形容尽力争权夺利。
暗度陈仓	an'du'chen'cang	《史记·高祖本纪》：“正月，项羽自立为西楚霸王，王梁楚地九郡，都彭城。负约，更立沛公为汉王，王巴、蜀、汉中，都南郑……汉王之国，项王使卒三万人从，楚与诸侯之慕从者数万人，从杜南入蚀中。去辄烧绝栈道，以备诸侯盗兵袭之，亦示项羽无东意……八月，汉王用韩信之计，从故道还，袭雍王章邯。邯迎击汉陈仓，雍兵败，还走；止战好畤，又复败，走废丘。汉王遂定雍地。东至咸阳，引兵围雍王废丘，而遣诸将略定陇西、北地、上郡。”陈仓，古县名，在今陕西省宝鸡市东，为通向汉中的交通孔道。后遂以“暗度陈仓”指正面迷惑敌人，而从侧翼进行突然袭击。亦比喻暗中进行活动。
暗箭难防	an'jian'nan'fang	比喻阴谋诡计难以防备。
暗箭伤人	an'jian'shang'ren	放冷箭伤害人。比喻用阴险的手段暗中攻击或陷害别人。语本宋刘炎《迩言》卷六：“暗箭中人，其深次骨，人之怨之，亦必次骨，以其掩人所不备也。”
暗绿稀红	an'lv'xi'hong	又作：绿肥红瘦。形容叶盛花稀的暮春景象。
暗室不欺	an'shi'bu'qi	虽在别人看不见的地方，也不做亏心事。谓光明磊落。语出唐骆宾王《萤火赋》：“类君子之有道，入暗室而不欺。”
暗室屋漏	an'shi'wu'lou	指别人看不见的地方；隐私之室。
暗送秋波	an'song'qiu'bo	本指女子暗中以眉目传情，引申为献媚取宠，暗中勾结。秋波，比喻美女的眼睛。语本宋苏轼《百步洪》诗之二：“佳人未肯回秋波，幼舆欲语防飞梭。”
暗无天日	an'wu'tian'ri	看不到一线光明。多形容政治腐败，社会黑暗。
暗香疏影	an'xiang'shu'ying	宋林逋《山园小梅》诗之一：“疏影横斜水清浅，暗香浮动月黄昏。”后遂以“暗香疏影”为梅花的代称。
暗中摸索	an'zhong'mo'suo	在黑暗中寻找探索。亦比喻无人指引，独自探求。
黯晦消沉	an'hui'xiao'chen	谓湮没消失。
黯然神伤	an'ran'shen'shang	心神悲沮貌。
黯然失色	an'ran'shi'se	指相比之下，事物仿佛失去原有的色泽、光彩。
黯然无色	an'ran'wu'se	指事物失去原有光彩，变得暗淡无光。
黯然销魂	an'ran'xiao'hun	心神沮丧，失魂落魄。
昂藏七尺	ang'cang'qi'chi	指轩昂伟岸的男子汉。
昂首阔步	ang'shou'kuo'bu	仰着头，迈着大步。形容精神奋发或态度傲慢。
昂首挺胸	ang'shou'ting'xiong	仰起头，挺起胸膛。形容无所畏惧或坚决的样子。
昂头阔步	ang'tou'kuo'bu	见“昂首阔步”。
昂头挺胸	ang'tou'ting'xiong	见“昂首挺胸”。
盎盂相击	ang'yu'xiang'ji	见“盎盂相敲”。
盎盂相敲	ang'yu'xiang'qiao	比喻家庭口角。
嗷嗷待哺	ao'ao'dai'bu	迫于饥饿而急于求食的样子。
遨翔自得	ao'xiang'zi'de	自由自在的样子。
熬肠刮肚	ao'chang'gua'du	谓从饮食方面尽力节俭。
熬更守夜	ao'geng'shou'ye	犹熬夜。
熬姜呷醋	ao'jiang'xia'cu	比喻生活清苦。
熬枯受淡	ao'ku'shou'dan	忍受清苦的生活。
熬清守淡	ao'qing'shou'dan	谓忍受清苦乏味的生活。
熬清受淡	ao'qing'shou'dan	见“熬清守淡”。
熬心费力	ao'xin'fei'li	谓耗费心神和气力。
熬油费火	ao'you'fei'huo	谓耗费灯油。多指日夜忙碌。
聱牙戟口	ao'ya'ji'kou	形容文词艰涩，拗口难读。
聱牙诘曲	ao'ya'jie'qu	见“聱牙诘屈”。
聱牙诘屈	ao'ya'jie'qu	形容文辞艰涩难读。
聱牙诎曲	ao'ya'qu'qu	见“聱牙诘屈”。
謷牙诘屈	ao'ya'jie'qu	同“诘屈聱牙”。謷，通“聱”。
鼇里夺尊	ao'li'duo'zun	又作：出类拔萃。
鼇头独占	ao'tou'du'zhan	比喻占首位或第一名。
鼇掷鲸呿	ao'zhi'jing'qu	见“鼇掷鲸吞”。
鼇掷鲸吞	ao'zhi'jing'tun	比喻文辞气势磅礴，跌宕起伏。
傲头傲脑	ao'tou'ao'nao	形容倔强的样子。
八拜之交	ba'bai'zhi'jiao	指结拜兄弟或姐妹的关系。
八窗玲珑	ba'chuang'ling'long	①唐卢纶《赋得彭祖楼送杨德宗归徐州幕》诗：“四户八窗明，玲珑逼上清。”后称四壁窗户轩敞，室内通彻明亮为“八窗玲珑”。亦作“八窗玲珑”。②比喻通达明澈的修养境界。
八窗玲珑	ba'chuang'ling'long	见“八窗玲珑”。
八方呼应	ba'fang'hu'ying	各方面声气相通，相互配合。
八府巡按	ba'fu'xun'an	巡按之名，起于明代，非固定职官，临时由朝廷委派监察御史担任，分别巡视各省，考核吏治。“八府巡按”常见于戏曲、小说，民间多视为清廉而有权势的大官。
八纮同轨	ba'hong'tong'gui	谓天下一统。
八面⒙珑	ba'mian'⒙'long	见“八面玲珑”。
八面见光	ba'mian'jian'guang	形容说话、做事圆转，面面俱到。亦以讥讽人圆滑世故，各方讨好。
八面玲珑	ba'mian'ling'long	①谓四壁窗户轩敞，室内通彻明亮。②形容物体外观挺秀。③形容圆活、灵秀。④形容人世故圆滑，面面俱到，或善于应酬，各方面的关系都能应付。
八面驶风	ba'mian'shi'feng	形容善于见风使舵，各方面都兜得传。
八面受敌	ba'mian'shou'di	①谓功力深厚，能应付各种情况。②砚名。
八面威风	ba'mian'wei'feng	①形容威风十足，声势慑人。②宋徽宗内库所藏玉杯名。见《通俗常言疏证·武备》引李绍闻《云间杂志》。
八面莹澈	ba'mian'ying'che	比喻精明练达，洞察一切。
八面张罗	ba'mian'zhang'luo	形容各方面都应酬得好。
八万四千	ba'wan'si'qian	本为佛教表示事物众多的数字，后用以形容极多。
八仙过海	ba'xian'guo'hai	相传八仙过海时不用舟船，各有一套法术。民间因有“八仙过海，各显神通”的谚语。明无名氏《八仙过海》第二折：“则俺这八仙过海神通大，方显这众圣归山道法强，端的万古名扬。”《西游记》第八一回：“正是八仙过海，独自显神通。”后以比喻各自拿出本领或办法，互相竞赛。
八音遏密	ba'yin'e'mi	《书·舜典》：“帝乃殂落，百姓如丧考妣。三载，四海遏密八音。”谓尧死，天下为之举哀，停止作乐。后以“八音遏密”指国君（或国家元首）去世。
八珍玉食	ba'zhen'yu'shi	泛指精美的肴馔。
八字打开	ba'zi'da'kai	意谓明白无隐，开门见山。
八字没见一撇	ba'zi'mei'jian'yi'pie	】	比喻事情毫无眉目，未见端绪。《通俗常言疏证》卷三：“《通俗编》：‘硃子《与刘子澄书》：圣贤已是八字打开了，人不自领会。’按今有‘八字不见两撇’之谚，似又因於此。凡事无端绪者，谓之八字不曾见两撇。”今通常作“八字没见一撇”。
巴巴急急	ba'ba'ji'ji	同“巴巴结结”。
巴巴劫劫	ba'ba'jie'jie	心情急切貌。
巴巴结结	ba'ba'jie'jie	①勉强，凑合。②勤恳；辛劳。③形容说话不流利。
巴高望上	ba'gao'wang'shang	犹高攀，向上爬。
巴高枝兒	ba'gao'zhi'er	比喻高攀。v
巴人下里	ba'ren'xia'li	①即下里巴人。古代楚国流行的民间歌曲。用以称流俗的音乐。巴，古国名，在今四川东部一带，古为楚地。下里，乡里。②泛指粗俗的作品。
巴三览四	ba'san'lan'si	东拉西扯。
巴山度岭	ba'shan'du'ling	爬山越岭。
巴山越岭	ba'shan'yue'ling	爬山越岭。形容善于登山行走。
扒耳搔腮	ba'er'sao'sai	形容焦急而又无可奈何。
扒高踩低	ba'gao'cai'di	比喻对上奉承攀附，对下欺侮压制。
拔本塞原	ba'ben'sai'yuan	亦作“拔本塞源”。①比喻背弃根本。②铲除事物发生的根源。多用于坏事。
拔本塞源	ba'ben'sai'yuan	见“拔本塞原”。
拔丛出类	ba'cong'chu'lei	又作：拔萃出类。
拔萃出类	ba'cui'chu'lei	同“出类拔萃”。谓高出众人。
拔萃出群	ba'cui'chu'qun	见“拔萃出类”。
拔刀相向	ba'dao'xiang'xiang	谓动武。
拔刀相助	ba'dao'xiang'zhu	拔出刀来助战。多指见义勇为。
拔丁抽楔	ba'ding'chou'xie	比喻排除疑难。丁，“钉”的古字。
拔锅卷席	ba'guo'juan'xi	①比喻带走全部家当。②又作：卷铺盖。比喻被解雇。
拔剑论功	ba'jian'lun'gong	争论功劳激烈到几乎动武。语出《史记·刘敬叔孙通列传》：“高帝悉去秦苛仪法，为简易。群臣饮酒争功，醉或妄呼，拔剑击柱，高帝患之。”
拔葵去织	ba'kui'qu'zhi	《史记·循吏列传》：“扞公仪休呴食茹而美，拔其园葵而弃之。见其家织布好，而疾出其家妇，燔其机，云：‘欲令农士工女安所雠其货乎？’”后以“拔葵去织”为居官不与民争利的典故。
拔来报往	ba'lai'bao'wang	速来速往。后以指往来频繁。报，通“赴”。语出《礼记·少仪》：“毋拔来，毋报往。”郑玄注：“报，读为‘赴疾’之‘赴’。拔、赴皆疾也。”
拔类超群	ba'lei'chao'qun	见“拔萃出类”。
拔毛济世	ba'mao'ji'shi	谓受轻微损失而能有利于世人。语出《列子·杨硃》：“禽子问杨硃曰：‘去子体之一毛以济一世，汝为之乎？’杨子曰：‘世固非一毛之所济。’禽子曰：‘假济，为之乎？’杨子弗应。”
拔茅连茹	ba'mao'lian'ru	比喻递相推荐引进。语出《易·泰》：“拔茅茹以其汇。”王弼注：“茅之为物，拔其根而相牵引者也。茹，相牵引之貌也。”硃熹本义：“三阳在下，拔茅连茹之象。”
拔苗助长	ba'miao'zhu'chang	同“揠苗助长”。
拔群出萃	ba'qun'chu'cui	高出众人。多指才能。
拔山盖世	ba'shan'gai'shi	谓勇猛无敌于天下。语出《史记·项羽本纪》：“力拔山兮气盖世，时不利兮骓不逝。”
拔山举鼎	ba'shan'ju'ding	同“拔山扛鼎”。
拔山扛鼎	ba'shan'kang'ding	形容力量超人或气势雄伟。语出《史记·项羽本纪》：“籍长八尺馀，力能扛鼎。”又：“力拔山兮气盖世。”
拔十得五	ba'shi'de'wu	谓选拔人才而得其半数。
拔十失五	ba'shi'shi'wu	谓选拔人才而失其半数。
拔树搜根	ba'shu'sou'gen	见“拔树寻根”。
拔树寻根	ba'shu'xun'gen	比喻追根究底，彻底查问。
拔犀擢象	ba'xi'zhuo'xiang	比喻提拔特出人才。
拔辖投井	ba'xia'tou'jing	谓殷勤留客饮酒。
拔新领异	ba'xin'ling'yi	创立新意，提出独特见解。
拔宅飞昇	ba'zhai'fei'sheng	见“拔宅上昇”。
拔宅上昇	ba'zhai'shang'sheng	《太平广记》卷十四引《十二真君传·许真君》：“真君以东晋孝武帝太康二年八月一日，於洪州西山，举家四十二口，拔宅上昇而去。”后因以“拔宅上昇”。指全家成仙。
拔赵易汉	ba'zhao'yi'han	见“拔赵帜易汉帜”。
拔赵帜立赤帜	ba'zhao'zhi'li'chi'zhi	】	见“拔赵帜易汉帜”。
拔赵帜易汉帜	ba'zhao'zhi'yi'han'zhi	】	据《史记·淮阴侯列传》载，韩信率汉军击赵，将至井陉口，先挑选轻骑二千，人持一赤帜，抄小路埋伏于赵营附近。接着背水列阵以诱赵。赵军出击，汉军佯败而走，赵军果空营追击。“信所出奇兵二千骑，共候赵空壁逐利，则驰入赵壁，皆拔赵旗，立汉赤帜二千。”赵军进击不能胜，欲回营，见营中尽是汉军赤帜，大惊，“以为汉皆已得赵王将矣”，于是溃不成军，终于为信所灭。后遂用以为偷换取胜或战胜、胜利之典。
拔帜树帜	ba'zhi'shu'zhi	同“拔赵帜易汉帜”。
跋胡疐尾	ba'hu'zhi'wei	《诗·豳风·狼跋》：“狼跋其胡，载疐其尾。”后以“跋胡疐尾”喻进退两难。
跋扈飞扬	ba'hu'fei'yang	骄横放肆。
跋扈自恣	ba'hu'zi'zi	专横强暴，为所欲为。
跋扈恣睢	ba'hu'zi'sui	见“跋扈自恣”。
跋来报往	ba'lai'bao'wang	匆匆地跑来跑去。跋，通“拔”。语本《礼记·少仪》：“毋拔来，毋报往。”郑玄注：“报读为赴疾之赴，拨、赴皆疾也。”
跋履山川	ba'lv'shan'chuan	同“跋山涉水”。
跋前踕后	ba'qian'jie'hou	同“跋胡疐尾”。
跋前疐后	ba'qian'zhi'hou	同“跋胡疐尾”。
跋前踬后	ba'qian'zhi'hou	同“跋胡疐尾”。
跋山涉川	ba'shan'she'chuan	见“跋山涉水”。
跋山涉水	ba'shan'she'shui	亦作“跋山涉川”。形容远道奔波之苦。
跋涉山川	ba'she'shan'chuan	同“跋山涉水”。
把臂入林	ba'bi'ru'lin	谓与友人一同归隐。
把饭叫饥	ba'fan'jiao'ji	比喻多此一举。
把酒持螯	ba'jiu'chi'ao	手持蟹螯饮酒。古人视为人生一大乐事。语本《晋书·毕卓传》：“卓尝谓人曰：‘得酒满数百斛船，四时甘味置两头，右手持酒杯，左手持蟹螯，拍浮酒船中，便足了一生矣。’”
罢於奔命	ba'yu'ben'ming	原谓因受命到处奔走而精疲力尽。后以指忙于奔走应付，非常疲劳。
霸道横行	ba'dao'heng'xing	又作：横行霸道。
白璧青蝇	bai'bi'qing'ying	唐陈子昂《宴胡楚真禁所》诗：“青蝇一相点，白璧遂成冤。”青蝇玷白璧，比喻谗人陷害忠良。
白璧三献	bai'bi'san'xian	楚人和氏得玉璞，两献楚王，两遭刖足。第三次王使治璞，得白玉，琢以为璧，世称“和氏璧”。见《韩非子·和氏》。后因以“白璧三献”喻不识良材或怀才不遇。
白璧微瑕	bai'bi'wei'xia	白玉上的小斑点。比喻美中不足，有小缺点。
白璧无瑕	bai'bi'wu'xia	①白玉上没有一点斑点。比喻品德完美。②喻女子坚贞自守。
白齿青眉	bai'chi'qing'mei	指青少年时期。
白藋同心	bai'diao'tong'xin	又作：心如野草。形容不羡荣华的品节。
白发青衫	bai'fa'qing'shan	①谓晚年得官。唐宋时文官品级低的穿青色服。②谓晚年尚作微官。
白黑不分	bai'hei'bu'fen	比喻清浊混乱，是非不明。
白黑颠倒	bai'hei'dian'dao	又作：白黑不分。
白虹贯日	bai'hong'guan'ri	①白色长虹穿日而过。一种罕见的日晕天象。古人认为人间有非常之事发生，就会出现这种天象变化。②比喻眼睛多白。
白华之怨	bai'hua'zhi'yuan	谓女子失宠之哀怨。
白话八股	bai'hua'ba'gu	用白话写的类似旧时八股式的文章。喻指应命而写的刻板文章。
白袷蓝衫	bai'jia'lan'shan	旧时士人的服装。亦借指尚未取得功名的士人。
白驹过郤	bai'ju'guo'xi	亦作“白驹过隙”。谓日影如白色的骏马飞快地驰过缝隙。形容时间过得极快。
白驹过隙	bai'ju'guo'xi	见“白驹过郤”。
白驹空谷	bai'ju'kong'gu	《诗·小雅·白驹》：“皎皎白驹，在彼空谷。”谓白驹在空谷。比喻贤人在野而不出仕。后亦以“白驹空谷”比喻贤人出仕而谷空。
白龙鱼服	bai'long'yu'fu	汉刘向《说苑·正谏》：“昔白龙下清泠之渊，化为鱼，渔者豫且射中其目。”后以“白龙鱼服”比喻贵人微服出行，恐有不测之虞。
白面儒冠	bai'mian'ru'guan	犹白面书生。
白面儒生	bai'mian'ru'sheng	犹白面书生。
白面书郎	bai'mian'shu'lang	犹白面书生。
白面书生	bai'mian'shu'sheng	指只知读书，阅历少，见识浅的读书人。有时含贬义。亦泛指读书人。
白帢青衫	bai'qia'qing'shan	古代士人所戴的帽和所穿的衣。因即指士人。
白日飞升	bai'ri'fei'sheng	见“白日飞昇”。
白日飞昇	bai'ri'fei'sheng	亦作“白日飞升”。犹白日升天。
白日见鬼	bai'ri'jian'gui	①旧喻官衙清闲冷落。②比喻虚妄荒诞，不可能出现的事。
白日青天	bai'ri'qing'tian	白天。表示强调。
白日上昇	bai'ri'shang'sheng	又作：白日升天。
白日昇天	bai'ri'sheng'tian	①道教谓人修炼得道后，白昼飞升天界成仙。②五代王定保《唐摭言·好放孤寒》：“元和十一年，岁在丙申，李凉公下三十三人，皆取寒素。时有诗曰：‘元和天子丙申年，三十三人同得仙，袍似烂银文似锦，相将白日上青天。’”后遂以喻指一朝显贵。
白日绣衣	bai'ri'xiu'yi	又作：衣锦昼行。旧时比喻有了功名富贵去夸耀乡里。
白日作梦	bai'ri'zuo'meng	见“白日做梦”。
白日做梦	bai'ri'zuo'meng	比喻幻想不可能实现。
白山黑水	bai'shan'hei'shui	长白山和黑龙江的合称。亦泛指我国东北地区。
白手成家	bai'shou'cheng'jia	见“白手起家”。
白手空拳	bai'shou'kong'quan	形容手中一无所有。
白手起家	bai'shou'qi'jia	形容原来无基础或条件很差而创出一番事业。
白手兴家	bai'shou'xing'jia	见“白手起家”。
白首北面	bai'shou'bei'mian	谓年已老犹从师受业。形容好学不倦。
白首空归	bai'shou'kong'gui	谓到老而无所成就。
白首齐眉	bai'shou'qi'mei	犹白首相庄。
白首穷经	bai'shou'qiong'jing	谓直到年老尚钻研经籍。形容好学不倦。
白首如新	bai'shou'ru'xin	同“白头如新”。
白首同归	bai'shou'tong'gui	晋潘岳《金谷集作诗》：“春荣谁不慕，岁寒良独希；投分寄石友，白首同所归。”原谓友谊坚贞，至老不变。南朝宋刘义庆《世说新语·仇隙》：“孙秀既恨石崇不与绿珠，又憾潘岳昔遇之不以礼……收石崇、欧阳坚石（欧阳建），同日收岳。石先送市，亦不相知。潘后至，石谓潘曰：‘安仁，卿亦复尔邪？’潘曰：‘可谓白首同所归。’”当时以为潘诗适成其谶。后转指年龄皆老而同时死亡。
白首为郎	bai'shou'wei'lang	《汉武故事》载：武帝尝至郎署，见郎官颜驷“须鬓皓白，衣服不整”。武帝问他：“何时为郎？”答道：“以文帝时为郎。”武帝又问为什么“老而不遇”？他回答说：“文帝好文而臣尚武，景帝好老而臣尚少，陛下好少而臣已老，是以三世不遇。”后因以“白首为郎”慨叹虽有才能而至老不遇。
白首相庄	bai'shou'xiang'zhuang	谓夫妇到老犹相敬爱。
白首一节	bai'shou'yi'jie	谓年虽老而志节不衰。
白天见鬼	bai'tian'jian'gui	见“白日见鬼”。
白头不终	bai'tou'bu'zhong	谓夫妇不能偕老。
白头叠雪	bai'tou'die'xue	见“白头蹀跇”。
白头蹀跇	bai'tou'die'yi	形容老人发白体弱。
白头而新	bai'tou'er'xin	同“白头如新”。
白头如新	bai'tou'ru'xin	谓相交虽久而并不知己，像新知一样。
白头相并	bai'tou'xiang'bing	又作：白头偕老。
白头偕老	bai'tou'xie'lao	谓夫妇共同生活到老。
白头之叹	bai'tou'zhi'tan	谓妇女被遗弃而作晚景凄凉之叹。
白兔赤乌	bai'tu'chi'wu	月亮和太阳的代称。多借指时间。
白屋之士	bai'wu'zhi'shi	指贫寒的士人。
白雪阳春	bai'xue'yang'chun	《白雪》《阳春》是战国时期楚国的两支高雅歌曲。见《文选·宋玉〈楚王问〉》。后亦用以泛指高雅的诗歌和其他文学艺术。
白衣苍狗	bai'yi'cang'gou	唐杜甫《可叹》诗：“天上浮云如白衣，斯须改变如苍狗。”后以“白衣苍狗”比喻世事变化无常。
白衣卿相	bai'yi'qing'xiang	指尚未发迹的读书人。
白衣秀士	bai'yi'xiu'shi	指尚未做官的读书人。
白衣宰相	bai'yi'zai'xiang	指宰相家属中身无名位而仗势擅权的人。
白蚁争穴	bai'yi'zheng'xue	比喻竞逐名利。
白鱼赤乌	bai'yu'chi'wu	《史记·周本纪》：“武王渡河，中流，白鱼跃入王舟中，武王俯取以祭。既渡，有火自上复于下，至于王屋，流为乌，其色赤，其声魄云。”后遂以“白鱼赤乌”为祥瑞之兆。
白鱼登舟	bai'yu'deng'zhou	见“白鱼入舟”。
白鱼入舟	bai'yu'ru'zhou	《尚书大传》卷三：“八百诸侯俱至孟津，白鱼入舟。”《史记·周本纪》：“武王渡河，中流，白鱼跃入王舟中，武王府取以祭。”裴骃集解引马融曰：“鱼者，介鳞之物，兵象也。白者，殷家之正色，言殷之兵众与周之象也。”后遂以“白鱼入舟”为殷亡周兴之兆。
白玉微瑕	bai'yu'wei'xia	见“白璧微瑕”。
白云苍狗	bai'yun'cang'gou	同“白衣苍狗”。
白云亲舍	bai'yun'qin'she	《旧唐书·狄仁杰传》：“其亲在河阳别业，仁杰赴并州，登太行山，南望见白云孤飞，谓左右曰：‘吾亲所居，在此云下。’瞻望伫立久之，云移乃行。”后因以“白云亲舍”为思念亲人的典故。
白纸黑字	bai'zhi'hei'zi	①白纸上留下了黑的字。比喻徒具形式。②比喻有确凿的文字凭据。
百八真珠	bai'ba'zhen'zhu	念珠。因念珠每串一百零八颗，故称。
百宝万货	bai'bao'wan'huo	指大量珍宝财物。
百不当一	bai'bu'dang'yi	一百个抵挡不住一个。
百不失一	bai'bu'shi'yi	又作：万无一失。形容绝不会失误。
百不为多，一不为少	bai'bu'wei'duo'-'yi'bu'wei'shao	不为少】	谓难得的好人或好东西。
百不一贷	bai'bu'yi'dai	又作：无一宽免。
百不一遇	bai'bu'yi'yu	一百次中遇不到一次。形容极其难得。
百步穿杨	bai'bu'chuan'yang	《史记·周本纪》：“楚有养由基者，善射者也。去柳叶百步而射之，百发而百中之。左右观者数千人，皆曰善射。”后因以“百步穿杨”形容射术非常高明。
百尺竿头	bai'chi'gan'tou	①桅杆及杂技长竿的顶端。②喻极高的官位和功名。③喻学问、事业有很高的成就。④佛教语。比喻道行达到极高的境界。
百尺无枝	bai'chi'wu'zhi	汉枚乘《七发》：“龙门之桐，高百尺而无枝。”后因以“百尺无枝”比喻罕见的大而有用之材。
百川朝海	bai'chuan'zhao'hai	众水奔流趋向大海。多比喻无数分散的事物都汇集到一处。
百川归海	bai'chuan'gui'hai	见“百川朝海”。
百代文宗	bai'dai'wen'zong	永为后世宗仰的文人。
百读不厌	bai'du'bu'yan	诵读多遍，不感厌倦。语出宋苏轼《送安惇秀才失解西归》诗：“旧书不厌百回读，熟读深思子自知。”后因以“百读不厌”形容文章高超。
百端待举	bai'duan'dai'ju	见“百凡待举”。
百堕俱举	bai'duo'ju'ju	同“百废俱兴”。
百二关河	bai'er'guan'he	同“百二山河”。
百二金瓯	bai'er'jin'ou	同“百二山河”。
百二山川	bai'er'shan'chuan	同“百二山河”。
百二山河	bai'er'shan'he	喻山河险固之地。
百发百中	bai'fa'bai'zhong	①形容射术高明，百不失一。②比喻料事和打算极有把握。
百凡待举	bai'fan'dai'ju	无数事情都等待兴办。
百废待举	bai'fei'dai'ju	见“百废待兴”。
百废待兴	bai'fei'dai'xing	谓许多被废置的事业都等着兴办。
百废具举	bai'fei'ju'ju	见“百废俱举”。
百废具兴	bai'fei'ju'xing	见“百废俱兴”。
百废具作	bai'fei'ju'zuo	同“百废俱兴”。
百废俱举	bai'fei'ju'ju	同“百废俱兴”。
百废俱兴	bai'fei'ju'xing	谓一切废置的事都兴办起来。
百废咸举	bai'fei'xian'ju	同“百废俱兴”。
百感交集	bai'gan'jiao'ji	种种感触交织在一起。形容感慨无比。
百怪千奇	bai'guai'qian'qi	形容花样繁多。
百鬼众魅	bai'gui'zhong'mei	各种妖魔鬼怪。
百花齐放，百家争鸣	bai'hua'qi'fang'-'bai'jia'zheng'ming	家争鸣】	比喻艺术上不同的形式和风格的自由发展，科学上不同学派的自由争论。是中国共产党１９５６年提出的文艺方针。
百花齐放	bai'hua'qi'fang	①谓千百种花同时开放，争奇斗艳。后借喻事物繁茂纷呈。②比喻艺术上的不同形式和风格自由地发展。参见“百花齐放，百家争鸣”。
百喙如一	bai'hui'ru'yi	又作：众口一辞。
百喙一词	bai'hui'yi'ci	见“百喙如一”。
百计千方	bai'ji'qian'fang	谓想尽或用尽所有办法。
百家争鸣	bai'jia'zheng'ming	原指我国战国时期学术界互相辩争的风气。当时学术派别很多，著名的有儒、法、道、墨、名、阴阳、纵横、农、杂等家。他们著书立说，游说争辩，形成“百家争鸣”的局面。这种局面，对当时思想、文化、学术的发展有很大的推动作用。后用以称学术研究中各抒己见以求发展的方法。
百结愁肠	bai'jie'chou'chang	谓愁绪如结无法解开。
百结悬鹑	bai'jie'xuan'chun	比喻衣衫破烂。鹑鸟尾秃，像补缀百结，故云。
百举百捷	bai'ju'bai'jie	见“百举百全”。
百举百全	bai'ju'bai'quan	做一百件事，成功一百件。谓办事万无一失。
百孔千疮	bai'kong'qian'chuang	亦作“百孔千创”。①比喻残破缺漏非常严重。②比喻弊病弱点很多。③比喻困苦不堪。
百孔千创	bai'kong'qian'chuang	见“百孔千疮”。
百口莫辩	bai'kou'mo'bian	谓纵有众多的嘴也不能辩解。
百里挑一	bai'li'tiao'yi	①形容不可多得。②谓挑选严格。
百里之命	bai'li'zhi'ming	指国君的政令。百里，指诸侯国。
百炼成钢	bai'lian'cheng'gang	铁经过多次锻炼，能炼成钢。比喻久经斗争生活的考验，变得非常坚强。
百虑一致	bai'lv'yi'zhi	谓使各种不同的思想归于一致。语出《易·系辞下》：“天下何思何虑，天下同归而殊涂，一致而百虑。”
百媚千娇	bai'mei'qian'jiao	极言娇媚动人。
百密一疏	bai'mi'yi'shu	在极周密的考虑中偶然出现了一点疏忽。
百年不遇	bai'nian'bu'yu	形容很少遇见。
百年大计	bai'nian'da'ji	指有关长远利益的计划或措施。
百年好事	bai'nian'hao'shi	指婚姻喜事。
百年树人	bai'nian'shu'ren	培育人才需要百年。谓育才是百年大计，要付出艰苦的劳动。
百年偕老	bai'nian'xie'lao	谓夫妻共同生活到老。
百年谐老	bai'nian'xie'lao	见“百年偕老”。
百年之好	bai'nian'zhi'hao	永久的好合。指男女结为夫妇。
百年之约	bai'nian'zhi'yue	即婚约。
百品千条	bai'pin'qian'tiao	繁多的名目。
百巧成穷	bai'qiao'cheng'qiong	见“百巧千穷”。
百巧千穷	bai'qiao'qian'qiong	谓有多种才能的人反而贫困不堪。
百忍成金	bai'ren'cheng'jin	《旧唐书·孝友传·张公艺》：“郓州寿张人张公艺，九代同居……麟德中，高宗有事泰山，路过郓州，亲幸其宅，问其义由。其人请纸笔，但书百馀‘忍’字。”后以“百忍成金”形容忍耐的可贵。
百舍重茧	bai'she'zhong'jian	见“百舍重趼”。
百舍重趼	bai'she'zhong'jian	亦作“百舍重茧”。百里一舍，足底老皮上又生出硬皮。形容长途奔走，十分辛劳。
百身何赎	bai'shen'he'shu	见“百身莫赎”。
百身莫赎	bai'shen'mo'shu	亦作“百身何赎”。谓一身虽百死亦不能补偿。
百世不磨	bai'shi'bu'mo	千秋万代永不磨灭。
百世不易	bai'shi'bu'yi	千秋万代永不改变。
百世流芳	bai'shi'liu'fang	美名永传于后世。
百世流芬	bai'shi'liu'fen	见“百世流芳”。
百世一人	bai'shi'yi'ren	谓极难得的人才。
百世之利	bai'shi'zhi'li	世世代代的利益。
百事大吉	bai'shi'da'ji	谓一切顺利；平安无事。
百兽率舞	bai'shou'shuai'wu	谓音乐和谐之声感动群兽相率起舞。
百顺百依	bai'shun'bai'yi	同“百依百随”。
百顺千随	bai'shun'qian'sui	同“百依百随”。
百思不解	bai'si'bu'jie	百般思索也不能理解。
百思莫解	bai'si'mo'jie	见“百思不解”。
百死一生	bai'si'yi'sheng	形容生命极其危险，处于死亡的边缘。
百岁之盟	bai'sui'zhi'meng	同“百年之约”。
百闻不如一见	bai'wen'bu'ru'yi'jian	】	多次听说还不及一次看到。意即耳闻是虚，眼见为实。
百无禁忌	bai'wu'jin'ji	谓一切不忌讳。
百无聊赖	bai'wu'liao'lai	指精神无所依托，非常无聊。
百无是处	bai'wu'shi'chu	又作：一无是处。形容全都是错的，没有一点对的地方。
百无所成	bai'wu'suo'cheng	又作：一事无成。
百无一成	bai'wu'yi'cheng	又作：一事无成。
百无一堪	bai'wu'yi'kan	谓百人中无一人能胜任。
百无一能	bai'wu'yi'neng	百事中无一事能做。形容人无能。
百无一失	bai'wu'yi'shi	见“百不失一”。
百无一是	bai'wu'yi'shi	谓百事之中无一件是正确的。表示对人对事的全盘否定。
百无一用	bai'wu'yi'yong	谓毫无用处。
百务具举	bai'wu'ju'ju	各种事务全都兴办。
百下百全	bai'xia'bai'quan	又作：百发百中，万无一失。
百下百着	bai'xia'bai'zhuo	见“百下百全”。
百依百顺	bai'yi'bai'shun	同“百依百随”。
百依百随	bai'yi'bai'sui	形容什么都顺从。
百载树人	bai'zai'shu'ren	见“百年树人”。
百战百败	bai'zhan'bai'bai	每战必败。
百战百胜	bai'zhan'bai'sheng	每战必胜；战无不胜。
百战不殆	bai'zhan'bu'dai	谓每战必胜，从不打败仗。
百战无前	bai'zhan'wu'qian	又作：所向无敌。
百丈竿头	bai'zhang'gan'tou	佛教语。百丈高的竿子。比喻道行已达极高的境界。
百折不摧	bai'zhe'bu'cui	同“百折不挠”。
百折不回	bai'zhe'bu'hui	同“百折不挠”。
百折不挠	bai'zhe'bu'nao	受到无数挫折都不屈服、动摇。形容意志坚强。
百折不屈	bai'zhe'bu'qu	同“百折不挠”。
百折不移	bai'zhe'bu'yi	屡遭挫折亦不改变其操守。
百折千回	bai'zhe'qian'hui	形容经过种种曲折和纡回。
百拙千丑	bai'zhuo'qian'chou	极言拙劣丑陋。
百紫千红	bai'zi'qian'hong	形容繁花似锦，色彩繁多。
百纵千随	bai'zong'qian'sui	同“百依百随”。
百足不僵	bai'zu'bu'jiang	见“百足之蟲，至死不僵”。
百足之蟲，断而不蹶	bai'zu'zhi'chong'-'duan'er'bu'jue	而不蹶】	见“百足之蟲，至断不蹶”。
百足之蟲，死而不僵	bai'zu'zhi'chong'-'si'er'bu'jiang	而不僵】	同“百足之蟲，至死不僵”。
百足之蟲，至断不蹶	bai'zu'zhi'chong'-'zhi'duan'bu'jue	断不蹶】	同“百足之蟲，至死不僵”。
百足之蟲，至死不僵	bai'zu'zhi'chong'-'zhi'si'bu'jiang	死不僵】	比喻势力雄厚的集体或个人一时不易垮台。
百足之蟲	bai'zu'zhi'chong	①马陆的别名。体长而稍扁，长寸余，由许多环节构成，各节有足一至二对。中断成两截，头尾仍能各自行走。多用以比喻故国、旧家或势位富厚的人。②蜈蚣的俗称。
败不旋踵	bai'bu'xuan'zhong	形容很快就遭到失败。
败材伤锦	bai'cai'shang'jin	《左传·襄公三十一年》：“扞子产谓子皮曰：呴‘子有美锦，不使人学制焉。大官大邑，身之所庇也，而使学者制焉。其为美锦，不亦多乎？’”《孟子·梁惠王下》：“孟子谓齐宣王曰：‘为巨室，则必使工师求大木。工师得大木，则王喜，以为能胜其任也。匠人斫而小之，则王怒，以为不胜其任矣。’”后以“败材伤锦”喻用非其人，伤害国家。
败国丧家	bai'guo'sang'jia	使国破家亡。
败国亡家	bai'guo'wang'jia	见“败国丧家”。
败化伤风	bai'hua'shang'feng	见“败俗伤化”。
败绩失据	bai'ji'shi'ju	谓事业失败而无所凭依。
败井颓垣	bai'jing'tui'yuan	又作：房毁墙坍。形容村舍荒凉。
败军之将	bai'jun'zhi'jiang	战败的将领。
败鳞残甲	bai'lin'can'jia	龙身上散落的鳞甲。比喻纷飞的雪花。
败柳残花	bai'liu'can'hua	比喻风尘女子。
败事有馀，成事不足	bai'shi'you'yu'-'cheng'shi'bu'zu	事不足】	谓非但办不好事情，反而常常把事情搞坏。
败俗伤风	bai'su'shang'feng	见“败俗伤化”。
败俗伤化	bai'su'shang'hua	谓败坏社会道德风气。
败於垂成	bai'yu'chui'cheng	谓临近成功时遭到失败。
拜赐之师	bai'ci'zhi'shi	春秋时，秦晋殽之战，秦将孟明视被俘。获释时，孟谓晋君曰：“三年将拜君赐。”后三年，秦果然出兵伐晋复仇。又败，晋人讥之为“拜赐之师”。见《左传·文公二年》。后因以讽刺为复仇而又失败的出兵。
稗耳贩目	bai'er'fan'mu	比喻见闻浅薄，如商贩之买货卖货。
稗官小说	bai'guan'xiao'shuo	即野史小说，街谈巷说之言。
稗官野史	bai'guan'ye'shi	泛称记载轶闻琐事的文字。
扳龙附凤	ban'long'fu'feng	谓依附龙凤而升空。
班驳陆离	ban'bo'lu'li	见“班駮陆离”。
班駮陆离	ban'bo'lu'li	亦作“班驳陆离”。同“斑駮陆离”。
班荆道故	ban'jing'dao'gu	见“班荆道旧”。
班荆道旧	ban'jing'dao'jiu	亦作“班荆道故”。谓朋友相遇于途，铺荆坐地，共叙情怀。典出《左传·襄公二十六年》：“楚伍参与蔡太师子朝友，其子伍举与声子相善……伍举奔郑，将遂奔晋。声子将如晋，遇之於郑郊，班荆相与食，而言复故。”杜预注：“班，布也。布荆坐地，共议归楚，事朋友世亲。”后泛指朋友相遇，共叙离情。
班门弄斧	ban'men'nong'fu	在鲁班门前摆弄斧子。鲁班即公输班，古代巧匠。比喻在行家面前卖弄本领，不自量力。
班香宋艳	ban'xiang'song'yan	班固和宋玉均善辞赋，以富丽见称，后以“班香宋艳”泛称辞赋之美者。
班衣戏采	ban'yi'xi'cai	相传老莱子七十岁时穿彩衣作兒戏以娱亲。后以“班衣戏采”为老养父母的孝亲典故。
斑驳陆离	ban'bo'lu'li	见“斑駮陆离”。
斑駮陆离	ban'bo'lu'li	亦作“斑驳陆离”。色彩斑斓绚丽貌。
斑衣戏彩	ban'yi'xi'cai	谓身穿彩衣，作婴兒戏耍以娱父母。《北堂书钞》卷一二九引《孝子传》言老莱子年七十，父母尚在，因常服斑衣，为婴兒戏以娱父母。
搬脣递舌	ban'chun'di'she	挑拨是非。
搬脣弄舌	ban'chun'nong'she	①挑拨是非。②卖弄口才。
搬脣弄舌	ban'chun'nong'she	见“搬脣弄舌”。
搬斤播两	ban'jin'bo'liang	谓盘剥克扣。
搬弄是非	ban'nong'shi'fei	把别人背后说的话传来传去，蓄意挑拨，或在别人背后乱加议论，引起纠纷。
阪上走丸	ban'shang'zou'wan	在斜坡上滚泥丸。极言其轻而易举。
板板六十四	ban'ban'liu'shi'si		宋时官铸铜钱，每板六十四文，不得增减。后因以“板板六十四”比喻刻板不知变通。
板上钉钉	ban'shang'ding'ding	比喻事情已定，不容变更或说话算数。
板上砸钉	ban'shang'za'ding	见“板上钉钉”。
版版六十四	ban'ban'liu'shi'si		宋代铸钱每版以六十四文为定数，不得增减。后因以“版版六十四”喻刻板守旧，不知变通。
版筑饭牛	ban'zhu'fan'niu	版筑，造土墙；饭牛，喂牛。相传商代贤者傅说筑于傅岩，武丁用以为相。事见《书·说命上》。春秋时卫国贤者宁戚饭牛车下，扣牛角而歌，桓公异之，拜为上卿。事见《吕氏春秋·举难》。后以“版筑饭牛”为贤臣出身微贱之典。
半半拉拉	ban'ban'la'la	不完整；未全部完成的。
半半路路	ban'ban'lu'lu	事物进行的过程中间。
半壁河山	ban'bi'he'shan	同“半壁江山”。
半壁江山	ban'bi'jiang'shan	谓国土的一部或大部分。
半壁山河	ban'bi'shan'he	同“半壁江山”。
半部论语	ban'bu'lun'yu	宋初宰相赵普，人言所读仅只《论语》而已。太宗赵匡义因此问他。他说：“臣平生所知，诚不出此，昔以其半辅太祖（赵匡胤）定天下，今欲以其半辅陛下致太平。”见宋罗太经《鹤林玉露》卷七。旧称半部《论语》治天下，典出于此。
半筹不纳	ban'chou'bu'na	半点计策也施展不出，半点办法也没有。
半筹莫展	ban'chou'mo'zhan	犹半筹不纳。
半低不高	ban'di'bu'gao	中等；不高不矮。
半懂不懂	ban'dong'bu'dong	不十分懂。
半饥半饱	ban'ji'ban'bao	谓不求甚饱或吃不饱饭。
半间半界	ban'jian'ban'jie	见“半间不界”。
半间不界	ban'jian'bu'jie	亦作“半间半界”。①不彻底，不深透。②不明确。③又作：不上不下。④谓平庸。
半截入土	ban'jie'ru'tu	谓人老，已快到寿终的时候。
半解一知	ban'jie'yi'zhi	同“一知半解”。理解得不深，知道得很少。
半斤八两	ban'jin'ba'liang	旧制一斤合十六两，半斤等于八两。半斤、八两轻重相等，比喻彼此不相上下。
半路出家	ban'lu'chu'jia	谓成年后才去做和尚、尼姑。比喻中途改业，不是科班出身。
半路修行	ban'lu'xiu'xing	见“半路出家”。
半梦半醒	ban'meng'ban'xing	谓睡眠尚未清醒。
半面之交	ban'mian'zhi'jiao	谓只见过一次面的交往。
半面之旧	ban'mian'zhi'jiu	谓只见过一次面的旧交。
半青半黄	ban'qing'ban'huang	庄稼未成熟时，青黄相间。比喻事物未达到成熟的境地。
半三不四	ban'san'bu'si	谓心神不定，无精打采。
半上半下	ban'shang'ban'xia	谓两可之间。
半上落下	ban'shang'luo'xia	犹半途而废。
半生半熟	ban'sheng'ban'shu	亦作“半生不熟”。①不熟悉；不熟练。②没有完全成熟或未烹煮至可食用的程度。
半生不熟	ban'sheng'bu'shu	见“半生半熟”。
半死半生	ban'si'ban'sheng	①未全死。②比喻无意义、无生气的苟且的生活。
半死不活	ban'si'bu'huo	亦作“半死辣活”。①不死不活。谓死又死不了，活着又受罪。②没有生气或活力。
半死辣活	ban'si'la'huo	见“半死不活”。
半涂而废	ban'tu'er'fei	半路上终止。比喻做事情有始无终。
半途而废	ban'tu'er'fei	见“半涂而废”。
半吐半露	ban'tu'ban'lu	见“半吞半吐”。
半推半就	ban'tui'ban'jiu	心里愿意，表面上却不肯答应或接受。形容假意推辞。
半吞半吐	ban'tun'ban'tu	亦作“半吐半露”。说一半留一半。形容说话不直截了当。
半文半白	ban'wen'ban'bai	亦作“半文不白”。文言和白话夹杂。
半文不白	ban'wen'bu'bai	见“半文半白”。
半新半旧	ban'xin'ban'jiu	不新不旧。
半新不旧	ban'xin'bu'jiu	见“半新半旧”。
半信半疑	ban'xin'ban'yi	犹半信不信。
半信不信	ban'xin'bu'xin	谓不完全相信。
半夜三更	ban'ye'san'geng	指午夜时。一夜分成五更，三更为午夜。亦泛指深夜。
半疑半信	ban'yi'ban'xin	同“半信半疑”。
伴食宰相	ban'shi'zai'xiang	《旧唐书·卢怀慎传》：“怀慎与紫微令姚崇对掌枢密，怀慎自以为吏道不及崇，每事皆推让之。时人谓之‘伴食宰相’。”后因以指身居相位而庸懦不能任事者。
伴食中书	ban'shi'zhong'shu	谓执政大臣庸懦而不堪任事。
帮虎吃食	bang'hu'chi'shi	亦作“帮狗吃食”。比喻帮坏人作坏事。
帮閒钻懒	bang'xian'zuan'lan	亦作“帮闲钻懒”。谓逢迎凑趣，耍弄乖巧。
帮闲钻懒	bang'xian'zuan'lan	见“帮閒钻懒”。
榜上无名	bang'shang'wu'ming	旧指科举考试落第未被录取。
蚌病成珠	bang'bing'cheng'zhu	《淮南子·说林训》：“明月之珠，蛖之病而我之利。”驅矗同“蚌”。后遂以“蚌病成珠”比喻因不得志而写出好文章来。尨，同“蚌”。后遂以“蚌病成珠”比喻因不得志而写出好文章来。
蚌病生珠	bang'bing'sheng'zhu	见“蚌病成珠”。
傍观者审，当局者迷	bang'guan'zhe'shen'-'dang'ju'zhe'mi	局者迷】	谓局外人对事物观察得周详慎密，当事人则往往会迷惑糊涂。
傍人篱壁	bang'ren'li'bi	比喻依赖他人。
傍人篱落	bang'ren'li'luo	见“傍2人篱壁”。
傍人门户	bang'ren'men'hu	宋苏轼《东坡志林》卷十二：“桃符仰视艾人而骂曰：‘汝何等草芥，辄居我上！’艾人俯而应曰：‘汝已半截入土，犹争高下乎？’桃符怒，往复纷然不已。门神解之曰：‘吾辈不肖，方傍人门户，何暇争闲气耶！’”后因以“傍人门户”谓依赖他人，不能自立。
傍若无人	bang'ruo'wu'ren	好象旁边没有人在。形容神情态度高傲自如。
棒打鸳鸯	bang'da'yuan'yang	喻用强硬手段拆散别人夫妻、情人等。
徬徨失措	pang'huang'shi'cuo	谓心神不宁，举动失常。
包办代替	bao'ban'dai'ti	谓应该和有关的人一起商量或一起做的事，却独自办理，不让旁人参与。
包藏祸心	bao'cang'huo'xin	暗藏着不可告人的坏心。
包藏奸心	bao'cang'jian'xin	又作：包藏祸心。
包揽词讼	bao'lan'ci'song	谓招揽承办别人的诉讼，从中谋利。
包罗万象	bao'luo'wan'xiang	包含容纳一切。形容内容丰富，无所不有。
包罗万有	bao'luo'wan'you	犹包罗万象。
包羞忍耻	bao'xiu'ren'chi	忍受耻辱，表示气量大。
苞藏祸心	bao'cang'huo'xin	同“包藏祸心”。心里隐藏着坏主意。苞，通“包”。
襃衣博带	bao'yi'bo'dai	宽衣大带。古代儒者的装束。
宝马香车	bao'ma'xiang'che	名贵的良马，华丽的车子。借指富贵之家出行的排场。
宝山空回	bao'shan'kong'hui	喻指置身良好环境，却空无所得。语本《心地观经·离世间品》：“如人无手，虽至宝山，终无所得。”
宝珠市饼	bao'zhu'shi'bing	唐皇甫□《原化记·贺知章》：“贺知章尝谒卖药王老，问黄白术，持一大珠遗之。老人得珠，即令易饼与贺食。贺心念宝珠何以市饼，老叟乃曰：‘慳吝未除，术何由成？’”后常以“宝珠市饼”喻指屏除凡欲，轻宝重道。
饱谙世故	bao'an'shi'gu	谓对世态人情有深刻感受或有丰富的处世经验。
饱经风霜	bao'jing'feng'shuang	谓经历过许多艰难困苦。
饱经风雨	bao'jing'feng'yu	同“饱经风霜”。
饱经世变	bao'jing'shi'bian	谓经历了许多人世变故。
饱经世故	bao'jing'shi'gu	谓阅历多，积累了丰富的处世经验。
饱经霜雪	bao'jing'shuang'xue	同“饱经风霜”。
饱经忧患	bao'jing'you'huan	谓经历了许多困苦患难。
饱练世故	bao'lian'shi'gu	同“饱谙世故”。
饱暖生淫欲	bao'nuan'sheng'yin'yu		见“饱暖思淫欲”。
饱暖思淫欲	bao'nuan'si'yin'yu		亦作“饱暖生淫欲”。谓生活安逸，易起淫念。
饱食暖衣	bao'shi'nuan'yi	吃得饱穿得暖。
饱食终日	bao'shi'zhong'ri	谓成天吃饱喝足，无所事事。
饱飨老拳	bao'xiang'lao'quan	谓挨一顿痛打。
饱学之士	bao'xue'zhi'shi	学识丰富的人。
饱以老拳	bao'yi'lao'quan	痛打，尽情地揍。语本《晋书·石勒载记下》：“孤往日厌卿老拳，卿亦饱孤毒手。”
保残守缺	bao'can'shou'que	①指汉代今文经学派儒生墨守残缺不全的今文经典而拘执一家之言。《汉书·刘歆传》：“信口说而背传记，是末师而非往古……犹欲保残守缺，挟恐见破之私意，而无从善服义之公心，或怀妒嫉，不考情实，雷同相从，随声是非，抑此三学。”清顾炎武《华阴县硃子祠堂上梁文》：“两汉而下，维多保残守缺之人，六经所传，未有继往开来之哲。”清魏源《礼记别考》：“汉初齐鲁诸儒，承秦灭学之后，保残守缺，未遑条贯。”后常用以比喻泥古守旧，不知改进。②指保藏残缺的古籍文献。
保家卫国	bao'jia'wei'guo	保卫家乡和祖国。
保泰持盈	bao'tai'chi'ying	指保持安定兴盛的局面。
保盈持泰	bao'ying'chi'tai	见“保泰持盈”。
报本反始	bao'ben'fan'shi	受恩思报，不忘本源。
报仇雪耻	bao'chou'xue'chi	报复冤仇，洗刷耻辱。
报仇雪恨	bao'chou'xue'hen	见“报雠雪恨”。
报雠雪恨	bao'chou'xue'hen	亦作“报仇雪恨”。报冤仇以洗雪心中之恨。
抱表寝绳	bao'biao'qin'sheng	坐卧不离准则。意谓坚持德操。
抱布贸丝	bao'bu'mao'si	以物易物。商品交换的一种形式。
抱残守缺	bao'can'shou'que	见“抱残守阙”。
抱残守阙	bao'can'shou'que	亦作“抱残守缺”。①守着残缺的东西不放。形容思想保守，不接受新事物。②谓笃守古学古道。③喻在条件很差的情况下坚持着做。
抱法处势	bao'fa'chu'shi	坚持法制，凭借权势。
抱关击柝	bao'guan'ji'tuo	守门打更的小吏。
抱关执籥	bao'guan'zhi'yue	持门闩，拿钥匙。指监门小吏的职务。
抱火卧薪	bao'huo'wo'xin	比喻处境险恶。语本汉贾谊《新书·数宁》：“夫抱火措之积薪之下而寝其上，火未及燃，因谓之安，偷安者也。方今之势，何以异此？”
抱蔓摘瓜	bao'wan'zhai'gua	摘完瓜连瓜蔓也抱去。比喻滥加株连，斩尽杀绝。语本唐李贤《黄台瓜辞》：“种瓜黄台下，瓜熟子离离。一摘使瓜好，再摘使瓜稀，三摘犹自可，摘绝抱蔓归。”
抱椠怀铅	bao'qian'huai'qian	同“握铅抱椠”。
抱头鼠窜	bao'tou'shu'cuan	形容急忙逃走的狼狈相。
抱甕灌园	bao'weng'guan'yuan	传说孔子的学生子贡，在游楚返晋过汉阴时，见一位老人一次又一次地抱着甕去浇菜，“搰搰然用力甚多而见功寡”，就建议他用机械汲水。老人不愿意，并且说：这样做，为人就会有机心，“吾非不知，羞而不为也。”见《庄子·天地》。后以“抱甕灌园”喻安于拙陋的淳朴生活。
抱薪救焚	bao'xin'jiu'fen	同“抱薪救火”。
抱薪救火	bao'xin'jiu'huo	比喻以错误的做法去消灭祸患，反而使祸患扩大。
抱玉握珠	bao'yu'wo'zhu	比喻满腹经纶，富有才学。语出三国魏曹植《与杨德祖书》：“当此之时，人人自谓握灵蛇之珠，家家自谓抱荆山之玉。”
抱枝拾叶	bao'zhi'shi'ye	又作：舍本逐末。
豹死留皮	bao'si'liu'pi	比喻留美名于身后。
鲍鱼之次	bao'yu'zhi'ci	见“鲍鱼之肆”。
鲍鱼之肆	bao'yu'zhi'si	亦作“鲍鱼之次”。卖咸鱼的店铺。鱼常腐臭，因以喻恶人之所或小人聚集之地。
鲍子知我	bao'zi'zhi'wo	《史记·管晏列传》：“管仲曰：‘吾始困时，当与鲍叔贾，分财利多自与，鲍叔不以我为贪，知我贫也。吾尝为鲍叔谋事而更穷困，鲍叔不以我为愚，知时有利不利也。吾尝三仕三见逐於君，鲍叔不以我为不肖，知我不遭时也。吾尝三战三走，鲍叔不以我为怯，知我有老母也。公子纠败，召忽死之，吾幽囚受辱，鲍叔不以我为无耻，知我不羞小节而耻功名不显于天下也。生我者父母，知我者鲍子也。’”后以“鲍子知我”谓彼此相互了解而情谊深切。
暴风疾雨	bao'feng'ji'yu	来势急遽而猛烈的风雨。
暴风骤雨	bao'feng'zhou'yu	①来势急遽而猛烈的风雨。②比喻声势浩大、发展迅猛的革命群众运动。
暴虎冯河	bao'hu'feng'he	典出《诗·小雅·小旻》：“不敢暴虎，不敢冯河。”空手搏虎，徒步渡河。比喻冒险行事，有勇无谋。
暴戾恣睢	bao'li'zi'sui	残暴凶狠，恣意横行。
暴敛横征	bao'lian'heng'zheng	强征捐税，搜刮人民财富。
暴露无遗	bao'lu'wu'yi	全部显露出来，一点也没有保留。
暴殄天物	bao'tian'tian'wu	①残害灭绝万物。②任意糟蹋东西。
暴跳如雷	bao'tiao'ru'lei	跳脚怒吼。形容大发脾气或十分着急的样子。
暴衣露盖	bao'yi'lu'gai	日晒衣裳，露湿车盖。形容奔波劳碌。
暴衣露冠	bao'yi'lu'guan	日晒衣裳，露湿冠冕。形容奔波劳碌。
暴躁如雷	bao'zao'ru'lei	犹暴跳如雷。
爆跳如雷	bao'tiao'ru'lei	盛怒貌。
陂湖禀量	bei'hu'bing'liang	语出《后汉书·黄宪传》：“叔度汪汪若千顷陂，澄之不清，淆之不浊，不可量也。”后因以“陂湖禀量”比喻度量宽广恢弘。
卑卑不足道	bei'bei'bu'zu'dao		谓卑微藐小，不值得一谈。
卑鄙龌龊	bei'bi'wo'chuo	丑恶肮脏。多指人的品质、行为。
卑鄙无耻	bei'bi'wu'chi	品行恶劣，不知廉耻。
卑不足道	bei'bu'zu'dao	见“卑卑不足道”。
卑辞厚币	bei'ci'hou'bi	见“卑辞重币”。
卑辞厚礼	bei'ci'hou'li	言辞谦恭，礼物丰厚。
卑辞重币	bei'ci'zhong'bi	谓言辞谦恭，礼物丰厚。
卑宫菲食	bei'gong'fei'shi	谓使宫室简陋，饮食菲薄。旧时用以称美朝廷自奉节俭的功德。语出《论语·泰伯》：“禹，吾无间然矣！菲饮食，而致孝乎鬼神；恶衣服，而致美乎黻冕；卑宫室，而尽力乎沟洫。”
卑躬屈节	bei'gong'qu'jie	见“卑躬屈膝”。
卑躬屈膝	bei'gong'qu'xi	弯腰下跪。形容毫无骨气，谄媚奉承。
卑礼厚币	bei'li'hou'bi	谓礼节谦恭，所赠币帛等礼物丰厚。
卑身贱体	bei'shen'jian'ti	①谓俭约勤苦。②弯腰俯首，屈从奉迎。
卑身屈体	bei'shen'qu'ti	见“卑身贱体”。
卑以自牧	bei'yi'zi'mu	谓以谦卑自守。语出《易·谦》：“谦谦君子，卑以自牧也。”王弼注：“牧，养也。”高亨注：“余谓牧犹守也，卑以自牧谓以谦卑自守也。”
卑之无甚高论	bei'zhi'wu'shen'gao'lun	】	《汉书·张释之传》：“释之既朝毕，因前言便宜事。文帝曰：‘卑之，毋甚高论，令今可行也。’”本谓要多谈当前可行的事，不要妄发过高的空论。后用来表示见解一般，没有什么独到之处。
杯羹之让	bei'geng'zhi'rang	《史记·项羽本纪》载，楚汉相争，汉军断绝楚军粮草，项羽把刘邦的父亲放在高高的肉案上，对刘邦说：“今不急下，吾烹太公。”刘邦说：“吾与项羽俱北面受命怀王，曰‘约为兄弟’，吾翁即若翁，必欲烹而翁，则幸分我一桮羹。”后因以“杯羹之让”谓受人挟持，惹人讥诮。
杯弓蛇影	bei'gong'she'ying	汉应劭《风俗通·怪神·世间多有见怪惊怖以自伤者》载：杜宣夏至日赴饮，见酒杯中似有蛇，然不敢不饮。酒后胸腹痛切，多方医治不愈。后得知壁上赤弩照于杯中，影如蛇，病即愈。《晋书·乐广传》等亦有类似记述。后因以“杯弓蛇影”比喻疑神疑鬼，自相惊扰。
杯弓蛇影	bei'gong'she'ying	汉应劭《风俗通·怪神·世间多有见怪惊怖以自伤者》：“予之祖父郴为汲令，以夏至日请见主簿杜宣，赐酒。时北壁上有悬赤弩，照於杯中，其形如蛇。宣畏恶之，然不敢不饮，其日便得腹腹痛切，妨损饮食，大用羸露，攻治万端，不为愈。后郴因事过至宣家闚视，问其变故，云畏此蛇，蛇入腹中。郴还听事，思惟良久，顾见悬弩，必是也。则使门下史将铃下侍徐扶辇载宣於故处设酒，杯中故复有蛇，因谓宣：‘此壁上弩影耳，非有他怪。’宣意遂解，甚夷怿，由是瘳平。”后遂以“杯弓蛇影”喻疑神疑鬼，自相惊扰。
杯弓蛇影	bei'gong'she'ying	汉应劭《风俗通·怪神·世间多有见怪惊怖以自伤者》：“予之祖父郴为汲令，以夏至日请见主簿杜宣，赐酒。时北壁上有悬赤弩，照於杯中，其形如蛇。宣畏恶之，然不敢不饮，其日便得腹腹痛切，妨损饮食，大用羸露，攻治万端，不为愈。后郴因事过至宣家闚视，问其变故，云畏此蛇，蛇入腹中。郴还听事，思惟良久，顾见悬弩，必是也。则使门下史将铃下侍徐扶辇载宣於故处设酒，杯中故复有蛇，因谓宣：‘此壁上弩影耳，非有他怪。’宣意遂解，甚夷怿，由是瘳平。”后遂以“杯弓蛇影”喻疑神疑鬼，自相惊扰。
杯弓市虎	bei'gong'shi'hu	谓捕风捉影，疑虑重重，自相惊扰。
杯觥交错	bei'gong'jiao'cuo	形容酒宴中相互频频举杯暢饮的热烈气氛。
杯觥交杂	bei'gong'jiao'za	又作：觥筹交错。形容宴饮热烈。
杯酒戈矛	bei'jiu'ge'mao	比喻在宴会上引起的仇恨或争斗。亦以喻相互倾轧。
杯酒解怨	bei'jiu'jie'yuan	谓饮酒言欢，消解仇怨。《旧唐书·张延赏传》：“及延赏当国用事，晟请一子聘其女，固情好焉，延赏拒而不许。晟谓人曰：‘武人性快，若释旧恶於杯酒之间，终欢可解。文士难犯，虽修睦於外，而蓄怒于内，今不许婚，釁未忘也。’”俗称“杯酒解怨”，本此。
杯茗之敬	bei'ming'zhi'jing	请人饮宴的谦辞。
杯盘狼籍	bei'pan'lang'ji	见“杯盘狼藉”。
杯盘狼藉	bei'pan'lang'jie	亦作“杯盘狼籍”。杯盘等放得乱七八糟。形容宴饮已毕或将毕时的情景。
杯蛇鬼车	bei'she'gui'che	指因疑虑、惊惧导致幻觉中产生的怪物。杯蛇，“杯弓蛇影”之省；鬼车，传说中的九头鸟。
杯蛇幻影	bei'she'huan'ying	同“杯弓蛇影”。
杯水车薪	bei'shui'che'xin	《孟子·告子上》：“今之为仁者，犹以一杯水救一车薪之火也。”后因以“杯水车薪”比喻力量微小，无济于事。
杯水粒粟	bei'shui'li'su	一杯水，一粒粟。谓极少量的饮食。
杯水舆薪	bei'shui'yu'xin	见“杯水车薪”。
杯水之敬	bei'shui'zhi'jing	又作：杯水之谢。
杯水之谢	bei'shui'zhi'xie	比喻微薄的酬谢。
杯影蛇弓	bei'ying'she'gong	同“杯弓蛇影”。
杯中蛇影	bei'zhong'she'ying	同“杯弓蛇影”。
悲不自胜	bei'bu'zi'sheng	悲伤得自己承受不了。
悲从中来	bei'cong'zhong'lai	悲伤或悲哀从心底里发出来。
悲愤填膺	bei'fen'tian'ying	悲痛和愤怒充满了胸膛。
悲歌击筑	bei'ge'ji'zhu	战国时，荆轲受燕太子丹托付，入秦刺秦王，太子及朋友们送别于易水，高渐离击筑，荆轲歌“风萧萧兮易水寒，壮士一去兮不复还”，登车不顾而去。见《史记·刺客列传》。后以“悲歌击筑”为典，抒写悲壮苍凉的气氛。
悲歌易水	bei'ge'yi'shui	见“悲歌击筑”。
悲欢离合	bei'huan'li'he	指人世间悲与欢、聚与散的遭遇。
悲声载道	bei'sheng'zai'dao	哀伤呼叫之声充满道路。形容苦难深重。
悲天悯人	bei'tian'min'ren	哀叹时世的艰辛，怜悯人民的疾苦。天，天命。指时世。
悲喜交集	bei'xi'jiao'ji	悲伤与喜悦交织在一起。
北鄙之声	bei'bi'zhi'sheng	见“北鄙之音”。
北鄙之音	bei'bi'zhi'yin	亦作“北鄙之声”。殷纣时的音乐。后世视为亡国之声。
北风之恋	bei'feng'zhi'lian	语本《古诗十九首·行行重行行》：“胡马依北风，越鸟巢南枝。”胡马，北方之马。诗人托物以喻意，后遂以“北风之恋”喻对故土的怀念。
北郭先生	bei'guo'xian'sheng	《韩诗外传》卷九载，北郭先生却楚庄王之聘不仕。《后汉书·方术传·廖扶》载，廖扶感父以法丧身，惮为吏，终身不仕，时人因号为北郭先生。后因用以指隐居不仕的人。
北门管钥	bei'men'guan'yue	犹北门之管。
北门锁钥	bei'men'suo'yue	北门之管。
北门之管	bei'men'zhi'guan	《左传·僖公三十二年》：“杞子自郑使告于秦曰：‘郑人使我掌其北门之管，若潜师以来，国可得也。’”杜预注：“管，钥也。”后因用以喻军事要地或守御重任。
北门之寄	bei'men'zhi'ji	谓负军事重任。
北叟失马	bei'sou'shi'ma	犹塞翁失马。喻因祸得福。
北辕適楚	bei'yuan'shi'chu	要到南方的楚国去，却驾车北行。比喻行为和目的相反。语本汉荀悦《申鉴·杂言下》：“先民有言：適楚而北辕者，曰：‘吾马良，用多，御善。’此三者益侈，其去楚亦远矣。”
北辕適粤	bei'yuan'shi'yue	犹北辕适楚。粤在南方。
北辙南辕	bei'zhe'nan'yuan	①想往南却驾车向北行驶。比喻行为和目的相反。②车子北往南来。喻人行无定迹。
贝阙珠宫	bei'que'zhu'gong	指用紫贝明珠装饰的龙宫水府。亦喻指瑶台仙境或帝王宫阙。
背暗投明	bei'an'tou'ming	背离黑暗，投向光明。旧时多比喻背离昏主，投向明君。
背碑覆局	bei'bei'fu'ju	看过的碑文能背诵，棋局乱后能复旧。指记忆力强。
背本就末	bei'ben'jiu'mo	背离根本，追逐末节。
背本趋末	bei'ben'qu'mo	谓弃农务商。我国古代以农为本，商为末。
背城借一	bei'cheng'jie'yi	①背对城墙对敌决一死战。指与敌人作最后决斗。②引申指作最后挣扎或斗争。
背城一战	bei'cheng'yi'zhan	①谓作最后决战。②引申指最后的斗争或努力。
背道而驰	bei'dao'er'chi	朝着相反的方向奔驰。常喻彼此的行动、目的相反。语本唐柳宗元《〈杨评事文集〉后序》：“其馀各探一隅，相与背驰於道者，其去弥远。”
背恩负义	bei'en'fu'yi	同“背恩忘义”。
背恩弃义	bei'en'qi'yi	见“背恩弃义”。
背恩弃义	bei'en'qi'yi	同“背恩忘义”。
背恩弃义	bei'en'qi'yi	同“背恩忘义”。
背恩忘义	bei'en'wang'yi	背弃恩德，忘却道义。
背腹受敌	bei'fu'shou'di	前后都受到敌人的攻击。
背公向私	bei'gong'xiang'si	见“背公营私”。
背公营私	bei'gong'ying'si	亦作“背公向私”。谓损公肥私，违法求利。
背惠食言	bei'hui'shi'yan	谓忘恩失信。
背井离乡	bei'jing'li'xiang	远离家乡，流落他方。
背前面后	bei'qian'mian'hou	指或当面或背后。
背曲腰躬	bei'qu'yao'gong	腰背弯曲。常指坐久或年老。
背曲腰弯	bei'qu'yao'wan	见“背曲腰躬”。
背山起楼	bei'shan'qi'lou	靠山建造楼房。谓好景被遮，比喻杀风景。
背水一战	bei'shui'yi'zhan	见“背水战”。
背乡离井	bei'xiang'li'jing	见“背井离乡”。
背信弃义	bei'xin'qi'yi	语本《北史·周纪下·高祖武帝》：“背惠怒邻，弃信忘义。”后以“背信弃义”谓不守信用和道义。
背义负恩	bei'yi'fu'en	同“背恩忘义”。
背义负信	bei'yi'fu'xin	见“背信弃义”。
背义忘恩	bei'yi'wang'en	同“背恩忘义”。
悖言乱辞	bei'yan'luan'ci	胡言乱语。
被宠若惊	bei'chong'ruo'jing	谓受到意外的恩遇而顿觉吃惊不安。
被发入山	bei'fa'ru'shan	谓归隐。
被发文身	bei'fa'wen'shen	古代吴越一带和某些南方民族的风俗。头发披散，身刺花纹。《礼记·王制》：“东方曰夷，被发文身，有不火食者矣。”章炳麟《驳康有为论革命书》：“禹入裸国，被发文身；墨子入楚，锦衣吹笙。”一说，截短头发，身刺花纹。
被发跣足	bei'fa'xian'zu	披散头发，赤着脚。
被发详狂	bei'fa'xiang'kuang	见“被发佯狂”。
被发佯狂	bei'fa'yang'kuang	披散头发，装作疯狂。古时作为一种避世全身的行为。
被发缨冠	bei'fa'ying'guan	披发散缨。形容匆忙急迫不及整束。
被发左衽	bei'fa'zuo'ren	头发披散不束，衣襟向左掩。古代指中原地区以外少数民族的装束。亦借指中原地区的人受少数民族统治。装束。亦借指中原地区的人受少数民族统治。
被褐藏辉	bei'he'cang'hui	又作：被褐怀玉。
被褐怀宝	bei'he'huai'bao	又作：被褐怀玉。
被褐怀玉	bei'he'huai'yu	身穿粗布衣服，怀中藏着宝玉。比喻人有才德而深藏不露。
被甲持兵	bei'jia'chi'bing	又作：被坚执锐。
被甲据鞍	bei'jia'ju'an	汉马援年六十二，请出征，光武帝以其老，未许。“援自请曰：‘臣尚能被甲上马。’帝令试之。援据鞍顾眄，以示可用。帝笑曰：‘矍铄哉是翁也！’”事见《后汉书·马援传》。后因以“披甲据鞍”形容武将年虽老而壮志不减。
被甲载兵	bei'jia'zai'bing	见“被甲持兵”。
被甲执兵	bei'jia'zhi'bing	见“被甲持兵”。
被甲执锐	bei'jia'zhi'rui	见“被坚执锐”。
被坚执锐	bei'jian'zhi'rui	穿坚固甲胄，握锐利武器。谓上阵战斗或作好战斗准备。
被山带河	bei'shan'dai'he	谓山势起伏，黄河如带。形容地势险固。
被绣之牺	bei'xiu'zhi'xi	《庄子·列御寇》：“或聘於庄子。庄子应其使曰：‘子见夫牺牛乎？衣以文绣，食以刍叔，及其牵而入於大庙，虽欲为孤犊，其可得乎！’”成玄英疏：“牺养丰赡，临祭日求为孤犊不可得也。况禄食之人，例多夭折，嘉遁之士，方足全生。庄子清高，笑彼名利。”后以“被绣之牺”比喻求得功名利禄而不能全其生的人。
被绣昼行	bei'xiu'zhou'xing	穿着锦绣衣服白天出行。谓富贵而夸耀于人。
被泽蒙庥	bei'ze'meng'xiu	受恩泽，蒙庇护。
被赭贯木	bei'zhe'guan'mu	穿囚衣，戴刑具。古代囚衣赤褐色，称“赭衣”。刑具加在颈上手上足上，称“三木”。
被硃佩紫	bei'zhu'pei'zi	穿红袍，挂紫绶。谓身为大官。
奔轶绝尘	ben'yi'jue'chen	见“奔逸绝尘”。
奔逸绝尘	ben'yi'jue'chen	形容跑得极快，迅速前进。绝尘，脚不沾尘土。
奔走呼号	ben'zou'hu'hao	①一面奔跑，一面叫喊。②谓到处宣传以唤起人们的醒觉。
奔走相告	ben'zou'xiang'gao	奔跑着递相传告。形容把消息迅速传开。
奔走之友	ben'zou'zhi'you	彼此尽力相助的挚友。
本固邦宁	ben'gu'bang'ning	谓人民安居乐业则国家太平。
本来面目	ben'lai'mian'mu	①佛教语。指人本有的心性。②原来的样子。
本末倒置	ben'mo'dao'zhi	比喻颠倒了事物的主次轻重。
本同末离	ben'tong'mo'li	本旨相同而途径不同。
本同末异	ben'tong'mo'yi	①开头或本源相同而末后或结果不同。②根本上相同，末节上不同。
本乡本土	ben'xiang'ben'tu	①本地。②家乡。
本支百世	ben'zhi'bai'shi	谓子孙昌盛，百代不衰。
本枝百世	ben'zhi'bai'shi	见“本支百世”。
坌鸟先飞	ben'niao'xian'fei	①笨鸟先飞。比喻笨人反而居先。②比喻能力差的人做事先行一步。多用做谦辞。
笨口拙舌	ben'kou'zhuo'she	见“笨嘴笨舌”。
笨鸟先飞	ben'niao'xian'fei	①比喻能力差的人做事时，怕趕不上别人，抢先动手。②用作谦词。
笨手笨脚	ben'shou'ben'jiao	谓动作不灵敏。
笨头笨脑	ben'tou'ben'nao	笨拙；愚蠢。
笨嘴笨舌	ben'zui'ben'she	说话表达能力很差，没有口才。
笨嘴拙舌	ben'zui'zhuo'she	见“笨嘴笨舌”。
逼不得已	bi'bu'de'yi	迫不得已。
逼良为娼	bi'liang'wei'chang	①谓强迫良家妇女卖淫。②比喻被迫做某件坏事。
逼人太甚	bi'ren'tai'shen	谓对人逼迫不留馀地。
逼上梁山	bi'shang'liang'shan	①《水浒传》里写北宋末年农民起义的故事，有林冲等被逼上梁山的情节。后用以指被迫走上反抗的道路。②比喻被迫采取某种行动。
鼻端出火	bi'duan'chu'huo	见“鼻头出火”。
鼻端生火	bi'duan'sheng'huo	语本《南史·曹景宗传》：“我昔在乡里，骑快马如龙……觉耳后生风，鼻头出火。”后因以“鼻端生火”形容马行疾速。
鼻垩挥斤	bi'e'hui'jin	挥舞斧头削除鼻端之垩。比喻指正错误。典出《庄子·徐无鬼》：“郢人垩漫其鼻端，若蝇翼，使匠石斫之，匠石运斤成风，听而斫之，尽垩而鼻不伤。”
鼻孔朝天	bi'kong'zhao'tian	见“鼻孔撩天”。
鼻孔辽天	bi'kong'liao'tian	见“鼻孔撩天”。
鼻孔撩天	bi'kong'liao'tian	仰起头来鼻孔朝天。形容高傲自大。
鼻青额肿	bi'qing'e'zhong	同“鼻青眼肿”。
鼻青脸肿	bi'qing'lian'zhong	同“鼻青眼肿”。
鼻青眼乌	bi'qing'yan'wu	同“鼻青眼肿”。
鼻青眼肿	bi'qing'yan'zhong	鼻子发青，眼睛肿起。形容脸部伤势严重。
鼻青眼紫	bi'qing'yan'zi	同“鼻青眼肿”。
鼻塌脣青	bi'ta'chun'qing	见“鼻塌嘴歪”。
鼻塌嘴歪	bi'ta'zui'wai	形容脸部伤势严重。
鼻头出火	bi'tou'chu'huo	形容意气风发；情绪激昂。
鼻肿眼青	bi'zhong'yan'qing	同“鼻青眼肿”。
匕鬯不惊	bi'chang'bu'jing	语本《易·震》：“震惊百里，不丧匕鬯。”后以“匕鬯不惊”形容法纪严明，无所惊扰。
比比皆是	bi'bi'jie'shi	到处都是；到处都有。
比户可封	bi'hu'ke'feng	见“比屋可封”。
比肩叠迹	bi'jian'die'ji	肩膀相靠，足迹相叠。形容人多。
比肩叠踵	bi'jian'die'zhong	形容人多。叠踵，脚尖踩脚跟。
比肩继踵	bi'jian'ji'zhong	肩碰肩，脚跟脚。形容人多拥挤。
比肩接踵	bi'jian'jie'zhong	犹比肩继踵。
比肩连袂	bi'jian'lian'mei	肩膀相并，衣袖相连。形容连接不断。
比肩随踵	bi'jian'sui'zhong	犹比肩继踵。
比肩系踵	bi'jian'xi'zhong	犹比肩继踵。
比量齐观	bi'liang'qi'guan	同等看待。
比权量力	bi'quan'liang'li	比较、较量权势和力量的大小。
比上不足，比下有馀	bi'shang'bu'zu'-'bi'xia'you'yu	下有馀】	谓处于中等状态。语出晋张华《鹪鹩赋》：“将以上方不足而下比有馀”。
比手划脚	bi'shou'hua'jiao	形容说话时用手势示意或加强语气。
比屋可封	bi'wu'ke'feng	①谓上古之世教化遍及四海，家家都有德行，堪受旌表。《尚书大传》卷五：“周人可比屋而封。”唐刘知几《史通·疑古》：“尧舜之人，比屋可封。盖因《尧典》成文，而广造奇说也。”后用以泛称风俗淳美。②形容多，到处都有。
比屋连甍	bi'wu'lian'meng	屋舍紧密相连。谓住户众多。
比物丑类	bi'wu'chou'lei	谓连缀同类事物，进行排比归纳。
比物假事	bi'wu'jia'shi	借助同类事物相比况。
比物连类	bi'wu'lian'lei	连缀相类的事物，进行排比归纳。
比物属事	bi'wu'shu'shi	连缀排比相类的事物。
比翼双飞	bi'yi'shuang'fei	比喻男女情投意合，结为伴侣。
彼一时，此一时	bi'yi'shi'-'ci'yi'shi	时】	谓时间不同，情况也不同。
秕言谬说	bi'yan'miu'shuo	错误的言论。
俾夜作昼	bi'ye'zuo'zhou	把夜晚当作白昼一般利用，夜以继日。
俾昼作夜	bi'zhou'zuo'ye	把白昼当作夜晚。指不分昼夜地寻欢作乐。
笔饱墨酣	bi'bao'mo'han	又作：笔酣墨饱。
笔底超生	bi'di'chao'sheng	又作：笔下超生。
笔底春风	bi'di'chun'feng	形容绘画、诗文生动，如春风来到笔下。
笔底龙蛇	bi'di'long'she	又作：笔走龙蛇。
笔伐口诛	bi'fa'kou'zhu	书面和口头宣布罪状，进行声讨。
笔歌墨舞	bi'ge'mo'wu	谓文笔奇妙精采。
笔酣墨饱	bi'han'mo'bao	谓文章表达流暢，内容充足。
笔翰如流	bi'han'ru'liu	谓文笔快捷无滞。
笔困纸穷	bi'kun'zhi'qiong	谓所写文字极多。
笔老墨秀	bi'lao'mo'xiu	谓笔姿老到而墨韵清秀。
笔墨官司	bi'mo'guan'si	指书面上的争辩。
笔墨横姿	bi'mo'heng'zi	谓书画诗文美妙多姿。
笔墨之林	bi'mo'zhi'lin	斯文萃集的地方。
笔头生花	bi'tou'sheng'hua	又作：笔生花。
笔误作牛	bi'wu'zuo'niu	《晋书·王献之传》：“桓温尝使扞王献之呴书扇，笔误落，因画作乌駮牸牛，甚妙。”后因以“笔误作牛”喻随机应变，化拙成巧或持功补过。
笔下超生	bi'xia'chao'sheng	在书写判决书等文书时，尽可能给予宽容或开脱。
笔下生花	bi'xia'sheng'hua	谓所写文章十分美妙。
笔冢研穿	bi'zhong'yan'chuan	秃笔成坟，砚磨穿孔。谓写作著述功力极深。
笔走龙蛇	bi'zou'long'she	喻文笔纵放，挥洒自如。
鄙夷不屑	bi'yi'bu'xie	轻视；看不起。
币重言甘	bi'zhong'yan'gan	礼物丰厚，言词谄媚。
必恭必敬	bi'gong'bi'jing	十分恭敬貌。必，通“毕”。语本《诗·小雅·小弁》：“维桑与梓，必恭敬止。”
必躬必亲	bi'gong'bi'qin	谓凡事都要自己经手。《诗·小雅·节南山》：“弗躬弗亲，庶民弗信。”后转为“必躬必亲”。
必也正名	bi'ye'zheng'ming	指必须按照正统伦理观念和礼仪关系来端正纲纪名分。
毕恭毕敬	bi'gong'bi'jing	十分恭敬的样子。
毕力同心	bi'li'tong'xin	又作：齐心协力。
毕其功于一役	bi'qi'gong'yu'yi'yi	】	①谓将本应分期分批做的事情一举全部完成。②以形容急于求成。
毕雨箕风	bi'yu'ji'feng	《书·洪范》：“庶民惟星，星有好风，星有好雨。”孔传：“箕星好风，毕星好雨，亦民所好。”原谓民性如星，星好风雨，喻庶民喜好人主的恩泽。后以“毕雨箕风”为颂扬统治者普施仁政之词。
闭壁清野	bi'bi'qing'ye	又作：坚壁清野。
闭閤思过	bi'he'si'guo	关起门来自我反省。
闭閤自责	bi'he'zi'ze	同“闭閤思过”。
闭关却扫	bi'guan'que'sao	见“闭门却扫”。
闭关自守	bi'guan'zi'shou	①封闭关口，不和别国往来。②比喻因循守旧，不接受外界事物的影响。
闭关自主	bi'guan'zi'zhu	见“闭关自守”。
闭境自守	bi'jing'zi'shou	封闭四境，严加防守。
闭口捕舌	bi'kou'bu'she	又作：甕中捉鳖。比喻敌方已被控制，无法逃脱。
闭口藏舌	bi'kou'cang'she	闭着嘴不说话。形容怕惹事而不轻易开口。语出五代冯道《舌》诗：“口是祸之门，舌是斩身刀。闭口深藏舌，安身处处牢。”
闭口结舌	bi'kou'jie'she	又作：闭口藏舌。
闭门合辙	bi'men'he'zhe	又作：闭门造车，出门合辙。比喻互相投合。
闭门墐户	bi'men'jin'hu	见“闭门塞窦”。
闭门觅句	bi'men'mi'ju	宋徐度《卻扫编》卷中：“（陈师道，字无己）与诸生徜徉林下，或愀然而归，径登榻，引被自覆，呻吟久之，矍然而兴，取笔疾书，则一诗成矣。”后因以“闭门觅句”形容作诗时冥思苦想。
闭门却轨	bi'men'que'gui	见“闭门埽轨”。
闭门却扫	bi'men'que'sao	关上大门，不打扫庭院路径。意为谢绝应酬，不与亲友往来。
闭门塞窦	bi'men'sai'dou	关闭门窗，堵塞洞穴。多谓防备之严。
闭门塞户	bi'men'sai'hu	见“闭门塞窦”。
闭门扫迹	bi'men'sao'ji	见“闭门埽轨”。
闭门埽轨	bi'men'sao'gui	谓杜绝宾客，不与来往。
闭门思过	bi'men'si'guo	同“闭閤思过”。
闭门思愆	bi'men'si'qian	同“闭閤思过”。
闭门投辖	bi'men'tou'xia	《汉书·游侠传·陈遵》：“遵耆酒，每大饮，宾客满堂，辄关门，取客车辖投井中，虽有急，终不得去。”辖，车轴的键，去辖则车不能行。后因以“闭门投辖”比喻主人留客的殷勤。
闭门造车	bi'men'zao'che	宋硃熹《〈四书〉或问》卷五：“古语所谓‘闭门造车，出门合辙’，盖言其法之同。”意思是只要按照同一规格，关起门来制造车辆，使用时也能和路上的车辙完全相合。宋陈亮《谢陈同知启》：“伏念某少览古书，恐遂流於无用；晚更世故，始渐见於难通。岂求田问舍之是专，亦闭门造车之可验。”后比喻办事只凭主观想象，不管客观实际。
闭门自守	bi'men'zi'shou	①闭门不出，洁身自保。②坚壁不出，严加防守。
闭明塞聪	bi'ming'sai'cong	堵塞视听。谓对外界事物不闻不问或不了解。
闭目塞耳	bi'mu'sai'er	同“闭明塞聪”。
闭目塞听	bi'mu'sai'ting	同“闭明塞聪”。
闭月羞花	bi'yue'xiu'hua	月亮见了躲藏起来，花兒见了感到羞惭。形容女子貌美。
荜露蓝蒌	bi'lu'lan'lou	见“荜路蓝缕”。
荜路蓝缕	bi'lu'lan'lv	同“筚路蓝缕”。形容创业的艰苦。
荜门圭窦	bi'men'gui'dou	同“筚门圭窦”。编竹为门，穿墙作窗。指贫穷人所居之处。
荜门委巷	bi'men'wei'xiang	指贫苦人家所居之处。
婢膝奴颜	bi'xi'nu'yan	谓卑躬屈膝谄媚奉承的奴才相。
婢作夫人	bi'zuo'fu'ren	张彦远《法书要录》卷二引南朝梁袁昂《古今书评》：“羊欣书如大家婢为夫人，虽处其位，而举止羞涩，终不似真。”后因谓刻意摹仿，而才力短弱不能神似者为“婢作夫人”。
敝盖不弃	bi'gai'bu'qi	谓破旧之物也自有其用。
敝鼓丧豚	bi'gu'sang'tun	击鼓宰猪而求神，徒使鼓破而猪失。谓徒劳无益。
敝綈恶粟	bi'ti'e'su	谓衣食粗劣。
敝帷不弃	bi'wei'bu'qi	谓破旧之物也自有用处。
敝衣粝食	bi'yi'li'shi	破衣粗食。形容生活困顿。
敝衣枵腹	bi'yi'xiao'fu	衣破肚饥。形容生活困顿。
敝帚千金	bi'zhou'qian'jin	《东观汉记·光武帝纪》：“家有敝帚，享之千金。”三国魏曹丕《典论·论文》：“夫人善於自见，而文非一体，鲜能备善，是以各以所长，相轻所短。里语曰‘家有弊帚，享之千金’，斯不自见之患也”。后因以“敝帚千金”比喻把自己并不一定好的东西视为宝贝。
敝帚自享	bi'zhou'zi'xiang	又作：敝帚自珍。
敝帚自珍	bi'zhou'zi'zhen	比喻东西虽不好，自己却很珍惜。语出宋陆游《初夏幽居》诗之二：“寒@不食犹能寿，弊帚何施亦自珍。”
筚路蓝缕	bi'lu'lan'lv	《左传·宣公十二年》：“筚路蓝缕，以启山林。”孔颖达疏：“以荆竹织门谓之筚门，则筚路亦以荆竹编车，故谓筚路为柴车。《方言》云：‘楚谓凡人家贫衣破丑敝为蓝缕。’蓝缕，谓敝衣也。”意思是坐着柴车，穿着破衣服去开辟山林。后因以“筚路蓝缕”形容创业艰辛。
筚路蓝褛	bi'lu'lan'lv	同“筚路蓝缕”。
筚路褴褛	bi'lu'lan'lv	同“筚路蓝缕”。
筚门圭窦	bi'men'gui'dou	见“筚门闺窦”。
筚门圭窬	bi'men'gui'yu	同“筚门闺窦”。
筚门闺窦	bi'men'gui'dou	柴门小户。喻指穷人的住处。
筚门闺窬	bi'men'gui'yu	同“筚门闺窦”。
弊车羸马	bi'che'lei'ma	破车瘦马。
弊绝风清	bi'jue'feng'qing	弊害之事绝迹，不正之风廓清。语本宋周敦颐《拙赋》：“上安下顺，风清弊绝。”
弊衣疏食	bi'yi'shu'shi	破旧的衣着，粗粝的饭食。谓生活清苦。
弊帚自珍	bi'zhou'zi'zhen	犹弊帚千金。
熚々剥剥	bi'々'bao'bao	见“熚々烞々”。
碧鬟红袖	bi'huan'hong'xiu	指代年轻貌美的女子。
蔽明塞聪	bi'ming'sai'cong	蒙住眼睛不视，堵塞耳朵不听。谓对外界事物不见不闻。
壁间蛇影	bi'jian'she'ying	据汉应劭《风俗通·怪神》所记：杜宣饮酒，见杯中似有蛇，酒后胸腹作痛，多方医治不愈；后知为壁上所悬赤弩照于杯，形如蛇，病即愈。《晋书·乐广传》也有类似记述。后因以“壁间蛇影”形容疑神疑鬼，徒自惊扰。
壁垒森严	bi'lei'sen'yan	①防御工事坚固；戒备严密。②比喻界限极其分明。
壁立千仞	bi'li'qian'ren	形容山崖石壁高峻陡峭。
避烦斗捷	bi'fan'dou'jie	谓避开烦难而比赛简捷。
避瓜防李	bi'gua'fang'li	见“避李嫌瓜”。
避毁就誉	bi'hui'jiu'yu	回避诋毁而追求称誉。
避祸就福	bi'huo'jiu'fu	谓避开灾祸而接近幸福。
避祸求福	bi'huo'qiu'fu	见“避祸就福”。
避迹藏时	bi'ji'cang'shi	逃避时世。
避迹违心	bi'ji'wei'xin	违背本意而隐匿。
避井入坎	bi'jing'ru'kan	见“避坑落井”。
避穽入坑	bi'jing'ru'keng	见“避坑落井”。
避军三舍	bi'jun'san'she	见“避君三舍”。
避君三舍	bi'jun'san'she	《左传·僖公二十三年》：“楚子飨之，曰：‘公子若反晋国，则何以报不穀？’……（重耳）对曰：‘若以君之灵，得反晋国，晋楚治兵，遇於中原，其辟君三舍。’”又《僖公二十八年》：“子犯曰；‘师直为壮，曲为老，岂在久乎？微楚之惠不及此，退三舍辟之，所以报也。’”杜预注：“一舍，三十里。初，楚子云：‘若反国何以报我？’故以退三舍为报。”后以“避君三舍”、“避军三舍”指退让和回避。
避坑落井	bi'keng'luo'jing	谓避过了坑，掉进了井里。比喻避去一害，又受另一害。
避李嫌瓜	bi'li'xian'gua	三国魏曹植《君子行》：“君子防未然，不处嫌疑间。瓜田不纳履，李下不整冠。”后以“避李嫌瓜”表示避免嫌疑。
避凉附炎	bi'liang'fu'yan	谓疏远避开无权势者，亲热攀附有权势者。
避面尹邢	bi'mian'yin'xing	汉武帝同时宠幸尹夫人与邢夫人，诏二人不得相见。尹夫人向武帝请求见邢夫人。相见后，尹夫人“乃低头俯而泣，自痛其不如也”。见《史记·外戚世家》。后以“避面尹邢”称因嫉妒而避不见面。
避难就易	bi'nan'jiu'yi	避开困难的而拣容易的做。
避难趋易	bi'nan'qu'yi	见“避难就易”。
避溺山隅	bi'ni'shan'yu	谓防止淹死而躲入山隅。表示远远回避。
避强打弱	bi'qiang'da'ruo	见“避强击弱”。
避强击惰	bi'qiang'ji'duo	见“避强击弱”。
避强击弱	bi'qiang'ji'ruo	亦作“避强击惰”。亦作“避强打弱”。军事用语。在运动战中避开敌人的精锐部队而专拣疲弱的打。
避人耳目	bi'ren'er'mu	谓避免走漏消息。
避人眼目	bi'ren'yan'mu	见“避人耳目”。
避实击虚	bi'shi'ji'xu	谓避开敌人的主力所在，攻击其防御薄弱之处。语出《孙子·虚实》：“水之行，避高而趋下；兵之形，避实而击虚。”
避实就虚	bi'shi'jiu'xu	见“避实击虚”。
避世金马	bi'shi'jin'ma	《史记·滑稽列传》：“（东方朔）时坐席中，酒酣，据地歌曰：‘陆沈於俗，避世金马门。宫殿中可以避世全身，何必深山之中、蒿庐之下！’”后以“避世金马”、“避世金门”谓身为朝官而逃避世务。
避世金门	bi'shi'jin'men	见“避世金马”。
避世离俗	bi'shi'li'su	逃避浊世，超脱凡俗。
避世墙东	bi'shi'qiang'dong	《后汉书·逸民传·逢萌》：“君公（王君公）遭乱独不去，侩牛自隐。时人谓之论曰：‘避世墙东王君公。’”后用“避世墙东”谓隐居于市井贩夫之中。
避俗趋新	bi'su'qu'xin	谓舍弃旧俗而追求新潮。
避凶趋吉	bi'xiong'qu'ji	谓避开祸害而趋向吉利。
避影敛迹	bi'ying'lian'ji	谓隐蔽起来，不露形迹。
避影匿形	bi'ying'ni'xing	见“避影敛迹”。
避之若浼	bi'zhi'ruo'mei	《孟子·公孙丑上》：“推恶恶之心，思与乡人立，其冠不正，望望然去之，若将浼也。”赵岐注：“与乡人立，见其冠不正，望望然，惭愧之貌也，去之恐其污己也。”后以“避之若浼”谓躲避惟恐不及，生怕沾污了自身。
避重就轻	bi'zhong'jiu'qing	①谓避开较重的责任，拣轻的承担。②谓躲开要害问题，只谈次要的事。
避重逐轻	bi'zhong'zhu'qing	见“避重就轻”。
髀肉复生	bi'rou'fu'sheng	谓因久不骑马，大腿上肉又长起来了。《三国志·蜀志·先主传》“荆州豪杰归先主者日益多，表疑其心，阴御之”裴松之注引晋司马彪《九州春秋》：“备住荆州数年，尝於表坐起至厕，见髀里肉生，慨然流涕。还坐，表怪问备，备曰：‘吾常身不离鞍，髀肉皆消。今不复骑，髀里肉生。日月若驰，老将至矣，而功业不建，是以悲耳。’”《三国演义》第三四回作“髀肉复生”。后因以“髀肉复生”为自叹壮志未酬，虚度光阴之辞。
璧合珠连	bi'he'zhu'lian	亦作“璧合珠联”。①谓日月如合璧，五星如连珠。古人认为是一种显示祥瑞的天象。②比喻众美毕集，相得益彰。
璧合珠联	bi'he'zhu'lian	见“璧合珠连”。
璧坐玑驰	bi'zuo'ji'chi	形容文章的语言精采美妙。
边尘不惊	bian'chen'bu'jing	喻边境安定无战事。
砭庸针俗	bian'yong'zhen'su	谓救治凡庸鄙陋。
鞭辟近里	bian'bi'jin'li	古代洛阳方言。意谓深入剖析，使靠近最里层。形容探求透彻，深入精微。宋儒常用语。
鞭辟入里	bian'bi'ru'li	同“鞭辟近里”。
鞭辟向里	bian'bi'xiang'li	同“鞭辟近里”。
鞭辟着里	bian'bi'zhuo'li	同“鞭辟近里”。
鞭长不及	bian'chang'bu'ji	见“鞭长不及马腹”。
鞭长不及马腹	bian'chang'bu'ji'ma'fu	】	语本《左传·宣公十五年》：“古人有言曰：‘虽鞭之长，不及马腹。’”杜预注：“言非所击。”谓鞭子虽然很长，但是不应该打到马肚上。后因以“鞭长不及马腹”喻力所不能及。
鞭长驾远	bian'chang'jia'yuan	谓路途遥远。
鞭长莫及	bian'chang'mo'ji	见“鞭长不及马腹”。
鞭驽策蹇	bian'nu'ce'jian	鞭打跑不快的马、驴。比喻自己能力低，但受到严格督促，勤奋不息。用作谦词。
鞭擗进里	bian'pi'jin'li	同“鞭辟近里”。
鞭擗向里	bian'pi'xiang'li	同“鞭辟近里”。
鞭丝帽影	bian'si'mao'ying	马鞭和帽子。借指出游。
鞭约近里	bian'yue'jin'li	又作：鞭辟近里。
抃风儛润	bian'feng'wu'run	欢舞于和风时雨中。指庆幸沾受恩惠。
便宜从事	bian'yi'cong'shi	谓可斟酌情势，不拘规制条文，不须请示，自行处理。
便宜施行	bian'yi'shi'xing	见“便宜从事”。
便宜行事	bian'yi'xing'shi	见“便宜从事”。
变本加厉	bian'ben'jia'li	原意是在本来的基础上更加发展。后多形容情况比原来更加严重。语本南朝梁萧统《〈文选〉序》：“盖踵其事而增华，变其本而加厉，物既有之，文亦宜然”。
变动不居	bian'dong'bu'ju	谓事物不断变化，没有固定的形态。
变风改俗	bian'feng'gai'su	见“变风易俗”。
变风易俗	bian'feng'yi'su	改变旧的风气和习俗。
变躬迁席	bian'gong'qian'xi	移动身体，离开席位。表示谦恭。
变古乱常	bian'gu'luan'chang	更改或打乱祖宗常法。
变古易常	bian'gu'yi'chang	改变过去的法制和习俗。语本《韩非子·南面》：“不知治者，必曰：‘无变古，毋易常。’”
变古易俗	bian'gu'yi'su	犹变古易常。
变故易常	bian'gu'yi'chang	同“变古易常”。
变化不测	bian'hua'bu'ce	变化无常，无法捉摸。
变化不穷	bian'hua'bu'qiong	见“变化无穷”。
变化莫测	bian'hua'mo'ce	见“变化不测”。
变化无常	bian'hua'wu'chang	谓变化不定，无规律可循。
变化无穷	bian'hua'wu'qiong	变化多种多样，没有穷尽。极言变化之多。
变幻不测	bian'huan'bu'ce	见“变幻莫测”。
变幻莫测	bian'huan'mo'ce	变化无常，无法捉摸。
变幻无穷	bian'huan'wu'qiong	形容变化之奇异和繁多。
变醨养瘠	bian'li'yang'ji	谓使薄酒变醇，瘠土变得肥沃。比喻改变贫穷落后面貌。
变脸变色	bian'lian'bian'se	见“变颜变色”。
变容改俗	bian'rong'gai'su	改变风貌习俗。
变生不测	bian'sheng'bu'ce	意外地发生变故。
变生肘腋	bian'sheng'zhou'ye	比喻变乱发生在内部或身旁。语本《三国志·蜀志·法正传》：“亮答曰：‘主公之在公安也，北畏曹公之彊，东惮孙权之逼，近则惧孙夫人生变於肘腋之下，当斯之时，进退狼跋。’”
变俗易教	bian'su'yi'jiao	改变原有的习俗和教化。
变态百出	bian'tai'bai'chu	形容事物形态变化之多。
变贪厉薄	bian'tan'li'bao	谓改变、劝勉贪图财利、行为轻薄的人使之廉洁忠厚。
变心易虑	bian'xin'yi'lv	改变思想；改变打算。
变炫无穷	bian'xuan'wu'qiong	犹变幻无穷。
变颜变色	bian'yan'bian'se	谓因内心惊、惧、急、怒而改变面色。
遍地开花	bian'di'kai'hua	比喻好事情到处涌现或普遍发展。
遍体鳞伤	bian'ti'lin'shang	①谓满身都是伤痕。形容伤势重。②比喻破坏严重，到处可见。
辨日炎凉	bian'ri'yan'liang	古代传说中辩论太阳离地远近的故事。《列子·汤问》：“孔子东游，见两小兒辩斗。问其故，一兒曰：‘我以日始出时去人近，而日中时远。’一兒曰：‘我以日初出远，而日中时近也。’一兒曰：‘日初出，大如车盖，及日中，则如盘盂：此不为远者小而近者大乎？’一兒曰：‘日初出，沧沧凉凉；及其日中，如探汤：此不为近者热而远者凉乎？’孔子不能决也。”后因以“辨日炎凉”谓兒童的聪明早慧。
辨如悬河	bian'ru'xuan'he	又作：口若悬河。辨，通“辩”。
辨若悬河	bian'ruo'xuan'he	见“辨如悬河”。
辨物居方	bian'wu'ju'fang	辨别众物的性质、条件等因素，使之各得其所。
辩才无碍	bian'cai'wu'ai	①佛教语。指佛、菩萨等讲解佛法道理圆通，言词流暢，毫无障碍。②泛指能言善辩。
辩才无阂	bian'cai'wu'he	同“辩才无碍”。
辩口利辞	bian'kou'li'ci	同“辩口利舌”。
辩口利舌	bian'kou'li'she	能言善辩，伶牙利嘴。
标情夺趣	biao'qing'duo'qu	谓传情逗趣。
标同伐异	biao'tong'fa'yi	谓助同道伐异己。
标新创异	biao'xin'chuang'yi	同“标新立异”。
标新竞异	biao'xin'jing'yi	同“标新立异”。
标新立异	biao'xin'li'yi	南朝宋刘义庆《世说新语·文学》：“支道林在白马寺中，将冯太常共语，因及《逍遥》，支卓然标新理於二家之表，立异义於众贤之外。”谓支解释《庄子·逍遥游》篇，有新的独到见解，与郭象、向秀诸家不同。后因以“标新立异”谓提出新的见解，表示与众不同。
标新领异	biao'xin'ling'yi	同“标新立异”。
标新竖异	biao'xin'shu'yi	同“标新立异”。
标枝野鹿	biao'zhi'ye'lu	《庄子·天地》：“至治之世，不尚贤，不使能，上如标枝，民如野鹿。”标枝，树梢之枝，比喻上古之世在上之君恬淡无为；野鹿，比喻在下之民放而自得。后因以“标枝野鹿”指太古时代。
膘肥体壮	biao'fei'ti'zhuang	形容牲畜肥壮结实。
飙发电举	biao'fa'dian'ju	形容声势迅猛。
飙举电至	biao'ju'dian'zhi	形容声势迅猛。
表里如一	biao'li'ru'yi	比喻思想和言行完全一致。
表里山河	biao'li'shan'he	《左传·僖公二八年》：“子犯曰：‘战也。战而捷，必得诸侯。若其不捷，表里山河，必无害也。’”杜预注：“晋国外河而内山。”后以谓有山河天险作为屏障。
表里为奸	biao'li'wei'jian	亦作“表里为奸”。内外互相勾结，施行奸计。
表里为奸	biao'li'wei'jian	见“表里为奸”。
表里相符	biao'li'xiang'fu	犹表里如一。
表里相依	biao'li'xiang'yi	谓关系密切，互相依存。
表里相应	biao'li'xiang'ying	内外互相应合。
表里一致	biao'li'yi'zhi	犹表里如一。
别抱琵琶	bie'bao'pi'pa	指改嫁。亦指移情他人。
别财异居	bie'cai'yi'ju	犹别籍异财。
别出机杼	bie'chu'ji'zhu	犹别出心裁。
别出手眼	bie'chu'shou'yan	见“别具手眼”。
别出心裁	bie'chu'xin'cai	亦作“别出新裁”。独创一格，与众不同。
别出新裁	bie'chu'xin'cai	见“别出心裁”。
别出新意	bie'chu'xin'yi	犹别出心裁。
别创一格	bie'chuang'yi'ge	亦作“别开一格”。谓开创一种新的风格或形式。
别风淮雨	bie'feng'huai'yu	南朝梁刘勰《文心雕龙·练字》：“《尚书大传》有‘别风淮雨’，《帝王世纪》云‘列风淫雨’。‘别’、‘列’、‘淮’、‘淫’，字似潜移。‘淫’、‘列’，义当而不奇，‘淮’、‘别’，理乖而新异。”后称用讹字以求新异为“别风淮雨”。
别鹤孤鸾	bie'he'gu'luan	比喻离散的夫妻。
别鹤离鸾	bie'he'li'luan	见“别鹤孤鸾”。
别籍异财	bie'ji'yi'cai	另立门户，各蓄家产。
别籍异居	bie'ji'yi'ju	另立门户，彼此分居。
别居异财	bie'ju'yi'cai	犹别籍异财。
别具肺肠	bie'ju'fei'chang	同“别有肺肠”。
别具匠心	bie'ju'jiang'xin	构思巧妙，与众不同。
别具手眼	bie'ju'shou'yan	亦作“别出手眼”。具有独到的眼光和手法。
别具心肠	bie'ju'xin'chang	同“别有肺肠”。
别具一格	bie'ju'yi'ge	具有独特的风格。
别具只眼	bie'ju'zhi'yan	具有独到的见解。
别开蹊径	bie'kai'xi'jing	另辟新路；独创一格。
别开生面	bie'kai'sheng'mian	唐杜甫《丹青引》：“凌烟功臣少颜色，将军下笔开生面。”赵次公注：“凌烟画像颜色已暗，而曹将军重为之画，故云开生面。”后因称开创新的风格、形式为“别开生面”。
别开一格	bie'kai'yi'ge	见“别创一格”。
别类分门	bie'lei'fen'men	按一定标准分成门类。
别生枝节	bie'sheng'zhi'jie	比喻另起事端或平添麻烦。
别树一旗	bie'shu'yi'qi	见“别树一帜”。
别树一帜	bie'shu'yi'zhi	亦作“别树一旗”。比喻与众不同，另成一家。
别无长物	bie'wu'chang'wu	没有多余的东西。后多形容空无所有。语出南朝宋刘义庆《世说新语·德行》：“王恭从会稽还，王大看之。见其坐六尺簟，因语恭：‘卿东来，故应有此物，可以一领及我。’恭无言，大去后，即举所坐者送之。既无馀席，便坐荐上。后大闻之，甚惊，曰：‘吾本谓卿多，故求耳。’对曰：‘丈人不悉恭，恭作人无长物。’”
别无二致	bie'wu'er'zhi	谓区分不出两者的差别。
别有洞天	bie'you'dong'tian	①谓尘世之外，另有仙境。洞天，道教用以称仙人所居之处。②另开一种境界。
别有肺肠	bie'you'fei'chang	语出《诗·大雅·桑柔》：“自有肺肠，俾民卒狂。”郑玄笺：“自有肺肠，行其心中之所欲。”后因以“别有肺肠”谓另有打算或企图。
别有风味	bie'you'feng'wei	另有特色。比喻事物具有特殊的风采或味道。
别有人间	bie'you'ren'jian	犹别有天地。
别有天地	bie'you'tian'di	另有一种境界。
别有心肠	bie'you'xin'chang	犹别有肺肠。
别有心肝	bie'you'xin'gan	犹别有肺肠。
别有用心	bie'you'yong'xin	①另外使用心力。②谓另有不可告人的企图。
别置一喙	bie'zhi'yi'hui	插一句嘴。比喻提出不同意见。
别作良图	bie'zuo'liang'tu	另作好的打算。
别作一眼	bie'zuo'yi'yan	谓另眼（相看）。
宾饯日月	bin'jian'ri'yue	迎送。宾，通“儐”。语出《书·尧典》：“分命羲仲，宅嵎夷，曰鲿[谷。寅宾出日，平秩东作。”又：“分命和仲，宅西，曰昧谷。寅饯纳日，平秩西成。”后多以“宾饯日月”谓岁月流逝。
宾来如归	bin'lai'ru'gui	见“宾至如归”。
宾入如归	bin'ru'ru'gui	见“宾至如归”。
宾至如归	bin'zhi'ru'gui	谓宾客到此如归其家。形容待客亲切、周到。
彬彬济济	bin'bin'ji'ji	人才盛多貌。
彬彬有礼	bin'bin'you'li	文雅而有礼貌。
冰寒于水	bing'han'yu'shui	《荀子·劝学》：“青，取之于蓝，而青于蓝；冰，水为之，而寒于水。”后遂以“冰寒于水”指后来居上。于，也写作“於”。
冰寒於水	bing'han'yu'shui	见“冰寒于水”。
冰魂素魄	bing'hun'su'po	同“冰魂雪魄”。
冰魂雪魄	bing'hun'xue'po	形容清白纯洁的品质。
冰肌玉骨	bing'ji'yu'gu	形容女子洁美的体肤。
冰洁玉清	bing'jie'yu'qing	同“冰清玉洁”。
冰洁渊清	bing'jie'yuan'qing	犹冰清玉洁。
冰解的破	bing'jie'di'po	冰冻融解，箭靶射中。比喻问题解决，障碍消除。
冰解冻释	bing'jie'dong'shi	比喻障碍和困难像冰融那样消释。
冰解壤分	bing'jie'rang'fen	冰冻消融，土壤分解。比喻障碍消除。
冰解云散	bing'jie'yun'san	同“冰消雾散”。
冰壸秋月	bing'kun'qiu'yue	喻人品德清白廉洁。
冰清水冷	bing'qing'shui'leng	冷冷清清。
冰清玉粹	bing'qing'yu'cui	同“冰清玉洁”。
冰清玉洁	bing'qing'yu'jie	比喻德行高洁。
冰清玉润	bing'qing'yu'run	①《世说新语·言语》“卫洗马初欲渡江”南朝梁刘孝标注引《卫玠别传》：“世咸谓诸王三子，不如卫家一恚娶乐广女。裴叔道曰：‘妻父有冰清之资，婿有璧润之望，所谓秦晋之匹也。’”《晋书·卫玠传》作“妇公冰清，女婿玉润”。后遂以“冰清玉润”为翁婿的美称。②比喻人品高洁。
冰散瓦解	bing'san'wa'jie	同“冰消瓦解”。
冰炭不同炉	bing'tan'bu'tong'lu		同“冰炭不同器”。
冰炭不同器	bing'tan'bu'tong'qi		比喻两种对立的事物不能同处。
冰天雪地	bing'tian'xue'di	冰雪漫天盖地。形容极为寒冷。
冰天雪窖	bing'tian'xue'jiao	同“冰天雪地”。
冰消冻解	bing'xiao'dong'jie	同“冰消瓦解”。
冰消瓦解	bing'xiao'wa'jie	比喻事物消失或崩溃。
冰消雾散	bing'xiao'wu'san	亦作“冰销雾散”。比喻事物消失瓦解。
冰消雪释	bing'xiao'xue'shi	同“冰消雾散”。
冰消云散	bing'xiao'yun'san	同“冰消雾散”。
冰销雾散	bing'xiao'wu'san	见“冰消雾散”。
冰销叶散	bing'xiao'ye'san	犹冰消瓦解。
冰雪聪明	bing'xue'cong'ming	形容人聪颖。
兵不接刃	bing'bu'jie'ren	作战时兵器没接触，谓战事顺利，未经交锋或激战而取得胜利。
兵不汙刃	bing'bu'wu'ren	犹兵不血刃。
兵不血刃	bing'bu'xue'ren	兵器上没有沾血，谓战事顺利，末经交锋或激战而取得胜利。
兵不厌诈	bing'bu'yan'zha	语本《韩非子·难一》：“战阵之閒，不厌诈伪。”《后汉书·虞诩传》亦有“兵不厌权”之语，后以“兵不厌诈”谓用兵作战时当尽量使用欺诈等计谋来迷惑敌人。
兵藏武库，马入华山	bing'cang'wu'ku'-'ma'ru'hua'shan	入华山】	兵器藏进武库，军马放入华山。谓天下太平。
兵贵神速	bing'gui'shen'su	①用兵以行动特别迅速为贵。语本《孙子·九地》：“兵之情主速。”②比喻处事以特别迅速为贵。
兵贵先声	bing'gui'xian'sheng	语本《史记·淮阴侯列传》：“兵固有先声而后实者，此之谓也。”后因以“兵贵先声”谓用兵贵在先以自己的声威慑服敌人。
兵荒马乱	bing'huang'ma'luan	形容战时动荡不安的景象。
兵慌马乱	bing'huang'ma'luan	见“兵荒马乱”。
兵来将挡，水来土掩	bing'lai'jiang'dang'-'shui'lai'tu'yan	来土掩】	见“兵来将敌，水来土堰”。
兵来将敌，水来土堰	bing'lai'jiang'di'-'shui'lai'tu'yan	来土堰】	谓根据具体情况，采取灵活的对付办法。
兵来将迎，水来土堰	bing'lai'jiang'ying'-'shui'lai'tu'yan	来土堰】	见“兵来将敌，水来土堰”。
兵连祸接	bing'lian'huo'jie	见“兵连祸结”。
兵连祸结	bing'lian'huo'jie	战争、灾祸连续不断。
兵临城下	bing'lin'cheng'xia	敌兵已到城墙之下。指大军压境，已遭围困，形势十分危急。
兵马未动，粮草先行	bing'ma'wei'dong'-'liang'cao'xian'xing	草先行】	作战时兵马还没出动，军用粮草的运输要先行一步。后泛指行动前须作好准备工作。
兵拏祸结	bing'na'huo'jie	见“兵连祸结”。
兵强马壮	bing'qiang'ma'zhuang	①士兵、军马强壮。指军队强大，有战斗力。②泛指强壮有力。
兵强则灭	bing'qiang'ze'mie	谓依恃军队强盛则毁灭。
兵戎相见	bing'rong'xiang'jian	指发生武装冲突。
兵未血刃	bing'wei'xue'ren	犹兵不血刃。
兵闻拙速	bing'wen'zhuo'su	谓用兵打仗当求速胜而患普椒ǖ那勺尽
兵无常势	bing'wu'chang'shi	用兵作战没有固定不变的方式。谓当根据敌情，采取灵活对策而取胜。
兵无常形	bing'wu'chang'xing	见“兵无常势”。
兵无血刃	bing'wu'xue'ren	同“兵不血刃”。
兵销革偃	bing'xiao'ge'yan	销毁兵器，放下甲盾。谓太平无战事。
兵行诡道	bing'xing'gui'dao	用兵可以实行诡异和诈伪的战法。语本《孙子·计》：“兵者，诡道也。”曹操注：“兵无常形，以诡诈为道。”
兵凶战危	bing'xiong'zhan'wei	语出汉晁错《言兵事疏》：“虽然，兵，凶器；战，危事也。故以大为小，以彊为弱，在俛卬之间耳。”后以“兵凶战危”谓战事凶险可怕。
秉公灭私	bing'gong'mie'si	主持公道，灭除私念。
秉公任直	bing'gong'ren'zhi	持心公正，处事正直。
秉节持重	bing'jie'chi'zhong	保持节操，谨慎稳重。
秉钧持轴	bing'jun'chi'zhou	执政掌权。
秉钧当轴	bing'jun'dang'zhou	又作：秉钧持轴。
秉文兼武	bing'wen'jian'wu	又作：能文能武。
秉文经武	bing'wen'jing'wu	执掌文事，经营武备。
秉要执本	bing'yao'zhi'ben	掌握要旨和根本。
秉正无私	bing'zheng'wu'si	主持正义，没有私念。
秉烛待旦	bing'zhu'dai'dan	执烛以待天明。言心情迫切，夜不能寐。
秉烛夜游	bing'zhu'ye'you	持烛夜游。谓须及时行乐。
炳如观火	bing'ru'guan'huo	见“炳若观火”。
炳若观火	bing'ruo'guan'huo	形容看得清楚明白。
并存不悖	bing'cun'bu'bei	同时存在而不冲突。
并驾齐驱	bing'jia'qi'qu	齐头并进。比喻彼此力量、地位、才能等不相上下。
并驾齐驱	bing'jia'qi'qu	齐头并进。比喻彼此力量、地位、才能等不相上下。
并疆兼巷	bing'jiang'jian'xiang	形容屋宅广大。
并驱争先	bing'qu'zheng'xian	谓竞争高下。
并日而食	bing'ri'er'shi	两天用一天的食粮。形容生活艰苦。
并容徧覆	bing'rong'bian'fu	广为包容覆庇。喻德化之广。
并世无两	bing'shi'wu'liang	犹举世无双。
并威偶势	bing'wei'ou'shi	谓聚集声威势力。
并行不悖	bing'xing'bu'bei	《礼记·中庸》：“万物并育而不相害，道并行而不相悖。”后以“并行不悖”指同时进行或同时存在而不相冲突。
并行不悖	bing'xing'bu'bei	《礼记·中庸》：“万物并育而不相害，道并行而不相悖。”后以“并行不悖”指同时进行或同时存在而不相冲突。
病从口入	bing'cong'kou'ru	谓疾病起于饮食不慎。
病笃乱投医	bing'du'luan'tou'yi		同“病急乱投医”。
病风丧心	bing'feng'sang'xin	同“病狂丧心”。
病国殃民	bing'guo'yang'min	又作：祸国殃民。
病急乱投医	bing'ji'luan'tou'yi		病情危急不审医术善否即求诊治。亦以喻事势危急盲目求援。
病入膏肓	bing'ru'gao'huang	谓病情险恶无法医治。亦以喻事势严重无可挽救。语本《左传·成公十年》：“公疾病，求医于秦。秦伯使医缓为之。未至，公梦疾为二竖子，曰：‘彼良医也，惧伤我，焉逃之。’其一曰：‘居肓之上，膏之下，若我何？’医至，曰：‘疾不可为也，在肓之上，膏之下，攻之不可，达之不及，药不至焉，不可为也。’公曰：‘良医也。’厚为之礼而归之。”
拨草寻蛇	bo'cao'xun'she	①比喻执意寻找。②比喻招惹恶人自找麻烦。
拨草瞻风	bo'cao'zhan'feng	喻善于观察事物。
拨乱反正	bo'luan'fan'zheng	治理混乱的局面，使恢复正常。语本《公羊传·哀公十四年》：“拨乱世，反诸正，莫近诸《春秋》。”何休注：“拨，犹治也。”
拨乱反治	bo'luan'fan'zhi	犹拨乱反正。
拨乱为治	bo'luan'wei'zhi	见“拨乱反治”。
拨万轮千	bo'wan'lun'qian	同“拨万论千”。
拨万论千	bo'wan'lun'qian	形容财产众多，花钱以万千计。
拨雨撩云	bo'yu'liao'yun	同“撩云拨雨”。
拨云见日	bo'yun'jian'ri	喻冲破黑暗，见到光明。
拨嘴撩牙	bo'zui'liao'ya	谓挑拨是非。
波波碌碌	bo'bo'lu'lu	奔走忙碌貌。
波骇云属	bo'hai'yun'shu	犹波属云委。
波谲云诡	bo'jue'yun'gui	①汉扬雄《甘泉赋》：“於是大厦云谲波诡，摧摧而成观。”本喻房屋建筑的千姿百态。后用“波谲云诡”以喻文章如波云变化多致。②喻事物变化多端，难以预料。
波澜壮阔	bo'lan'zhuang'kuo	比喻气势雄壮浩大。
波流茅靡	bo'liu'mao'mi	随波逐流，随风而倒。比喻胸无定见，趋势而行。
波罗塞戏	bo'luo'sai'xi	即双陆。古代游戏，二人相博，类似下棋。
波罗奢花	bo'luo'she'hua	即鸡冠花。
波属云委	bo'shu'yun'wei	如波之相接，云之相叠。比喻连续不断，层见叠出。
剥肤及髓	bao'fu'ji'sui	喻盘剥深重。
剥极必复	bao'ji'bi'fu	见“剥极将复”。
剥极将复	bao'ji'jiang'fu	亦作“剥极则复”。亦作“剥极必复”。剥卦阴盛阳衰，复卦阴极而阳复。后以喻物极必反，否极泰来。
剥极则复	bao'ji'ze'fu	见“剥极将复”。
剥茧抽丝	bao'jian'chou'si	喻根据顺序寻求事物的发生发展过程。
播穅眯目	bo'kang'mi'mu	谓散布糠屑以迷人目。比喻被外物蒙蔽而迷失方向。
播糠眯目	bo'kang'mi'mu	见“播穅眯目”。
伯歌季舞	bo'ge'ji'wu	谓兄弟友爱和好。伯，兄；季，弟。
伯劳飞燕	bo'lao'fei'yan	《玉台新咏·古词〈东飞伯劳歌〉》：“东飞伯劳西飞燕，黄姑织女时相见。”后以“伯劳飞燕”借指离别的亲人或朋友。
伯乐相马	bo'le'xiang'ma	伯乐观察、品评马的优劣。比喻有眼力者鉴别并荐举人才。
伯乐一顾	bo'le'yi'gu	战国时，苏代说淳于髡，谓人有告伯乐曰，臣有骏马欲卖，连三旦立于市，人莫与言；愿子一顾之，请献一朝之费。伯乐乃环而视之，去而顾之，一旦而马价十倍。见《战国策·燕策二》。后以“伯乐一顾”比喻受人知遇赏识。
伯仲之间	bo'zhong'zhi'jian	比喻人或事物不相上下，难分优劣高低。
驳瑕指颣	bo'xia'zhi'lei	指斥缺点。
博大精深	bo'da'jing'shen	谓理论、学识、思想、作品等广博丰富，深奥精微。多用于抽象事物。
博古通今	bo'gu'tong'jin	通晓古今的事情。形容学识渊博。
博览五车	bo'lan'wu'che	谓读书多，学识渊博。
博施济众	bo'shi'ji'zhong	广施恩惠，拯救众民。语出《论语·雍也》：“子财曰：‘如有博施於民而能济众，何如？可谓仁乎？’”
博士买驴	bo'shi'mai'lv	北齐颜之推《颜氏家训·勉学》：“问一言辄酬数百，责其指归，或无要会。郲下谚云：‘博士买驴，书券三纸，未有驴字。’”后以“博士买驴”表示文词繁冗，不得要领的意思。
博硕肥腯	bo'shuo'fei'tu	肥壮。多指六畜肥壮。
博文约礼	bo'wen'yue'li	广求学问，恪守礼法。约，约束。语本《论语·雍也》：“子曰：‘君子博学於文，约之以礼，亦可以弗畔矣夫！’”
博闻强记	bo'wen'qiang'ji	同“博闻强识”。
博闻强识	bo'wen'qiang'shi	见闻广博，记忆力强。
博闻强志	bo'wen'qiang'zhi	同“博闻强识”。
博物君子	bo'wu'jun'zi	博学多识的人。
博物洽闻	bo'wu'qia'wen	见多识广，知识渊博。
博弈犹贤	bo'yi'you'xian	语出《论语·阳货》：“子曰：‘饱食终日，无所用心，难矣哉！不有博弈者乎？为之，犹贤乎已。’”后谓不要饱食终日无所事事为“博弈犹贤”。
渤澥桑田	bo'xie'sang'tian	大海变成桑田，桑田变成大海。比喻世事变化巨大。
踣地呼天	bo'di'hu'tian	又作：呼天抢地。形容极度悲伤。
薄物细故	bao'wu'xi'gu	微细的事情。
跛鳖千里	bo'bie'qian'li	跛脚的鳖不停地走，也能走千里地。比喻只要努力不懈，即使条件很差，也能取得成就。
簸土扬沙	bo'tu'yang'sha	指虚张声势。
簸扬糠粃	bo'yang'kang'bi	见“簸之扬之，穅粃在前”。
簸之扬之，穅粃在前	bo'zhi'yang'zhi'-'kang'bi'zai'qian	粃在前】	①谓扬米去糠，糠在米上。穅，同“糠”。南朝宋刘义庆《世说新语·排调》：“王文度、范荣期俱为简文所要，范年大而位小，王年小而位大，将前，更相推在前，既移久，王遂在范后。王因谓曰：‘簸之扬之，穅粃在前。’范曰：‘洮之汰之，沙砾在后。’”本为调侃之词，谓位卑而居前列。后亦用为谦词，谓无才而居前。穅，亦写作“糠”。②用为出任地方官之谦词。
擘肌分理	bo'ji'fen'li	①喻分析精密。理，肌肉的纹理。②谓苛细。
擘两分星	bo'liang'fen'xing	谓很小的重量都分辨得清清楚楚。喻准确清楚。两，较小的重量单位；星，秤杆上标记斤两的小点子。
餔糟啜漓	bu'zao'chuo'li	见“餔糟歠醨”。
餔糟啜醨	bu'zao'chuo'li	见“餔糟歠醨”。
餔糟歠漓	bu'zao'chuo'li	见“餔糟歠醨”。
餔糟歠醨	bu'zao'chuo'li	亦作“餔糟啜醨”。亦作“餔糟歠漓”。①吃酒糟，喝薄酒。谓追求一醉。语本《楚辞·渔父》：“众人皆醉，何不餔其糟而歠其酾？”《文选》酾作“醨”。吕向云：“餔糟歠醨，微同其事也。餔，食也。歠，饮也。糟、醨，皆酒滓。”洪兴祖补注：“醨，薄酒也。”②比喻屈志从俗；随波逐流。③比喻文字优美，令人陶醉。
补残守缺	bu'can'shou'que	又作：抱残守缺。
补过饰非	bu'guo'shi'fei	掩饰过错。
补苴罅漏	bu'ju'xia'lou	弥补事物的缺陷和漏洞。
补厥挂漏	bu'jue'gua'lou	又作：补苴罅漏。
补牢顾犬	bu'lao'gu'quan	丢失了羊，才修补羊圈；见了野兔，才回头唤狗去追捕。比喻对出现的失误，及时设法补救。语本《战国策·楚策四》：“见兔而顾犬，未为晚也；亡羊而补牢，未为迟也。”
补漏订讹	bu'lou'ding'e	补充缺漏，订正错误。
补偏救弊	bu'pian'jiu'bi	补正偏差，挽救弊病。
补天浴日	bu'tian'yu'ri	古代神话传说，女娲炼石补天和羲和浴日甘渊的并称。见《列子·汤问》、《山海经·大荒南经》。后用以比喻力挽世运功勋卓著或挽回危局。
哺糟啜醨	bu'zao'chuo'li	见“哺糟歠醨”。
哺糟歠醨	bu'zao'chuo'li	亦作“哺糟啜醨”。语本《楚辞·渔父》“众人皆醉，何不餔其糟而歠其醨”。后以“哺糟歠醨”比喻效法时俗，随波逐流。
捕风捉影	bu'feng'zhuo'ying	《汉书·郊祀志下》有“听其言，洋洋满耳，若将可遇，求之，荡荡如系风捕景，终不可得”语。后多作“捕风捉影”。喻虚幻无实或无根据地臆测。
捕影系风	bu'ying'xi'feng	见“捕风捉影”。
不安於室	bu'an'yu'shi	《诗·邶风·凯风序》：“卫之淫风流行，虽有七子之母，犹不能安其室。”郑玄笺：“不安其室，欲去嫁也。”后因以“不安於室”为已婚妇女思涉外遇或寡妇意欲再嫁的婉辞。
不按君臣	bu'an'jun'chen	中医处方，以君臣相配为原则。君是主药，臣是辅药。不按君臣，就是违反药理，胡乱用药。引申为使用毒药的隐语。
不拔一毛	bu'ba'yi'mao	同“一毛不拔”。比喻非常吝啬。
不白之冤	bu'bai'zhi'yuan	得不到辩白、昭雪的冤屈。
不卑不亢	bu'bei'bu'kang	同“不亢不卑”。
不避斧钺	bu'bi'fu'yue	谓不怕杀头。斧钺，古代用以杀人的武器。钺，形似斧而大。语出《汉书·赵充国传》：“愚臣伏计孰甚，不敢避斧钺之诛，昧死陈愚，唯陛下省察。”
不避水火	bu'bi'shui'huo	见“不避汤火”。
不避汤火	bu'bi'tang'huo	指不畏凶险。
不便水土	bu'bian'shui'tu	同“不服水土”。
不辨菽麦	bu'bian'shu'mai	形容愚昧无知。今亦指脱离生产实践，缺乏实际知识。
不辨菽粟	bu'bian'shu'su	犹不辨菽麦。粟，小米。
不辩菽麦	bu'bian'shu'mai	同“不辨菽麦”。
不步人脚	bu'bu'ren'jiao	不跟着别人的脚步走。喻不因循守旧。
不测之忧	bu'ce'zhi'you	意外的祸患。
不测之罪	bu'ce'zhi'zui	指大罪，死罪。
不成体统	bu'cheng'ti'tong	形容办事没有一定的体制、规矩，不成样子。
不逞之徒	bu'cheng'zhi'tu	《左传·襄公十年》：“司马、堵氏、侯氏、子师氏皆丧田焉。故五族聚群不逞之人，因公子之徒以作乱。”后因称犯法为非的人为不逞之徒。
不痴不聋	bu'chi'bu'long	古代谚语。语本《太平御览》卷四九六引《慎子》逸文：“谚云：不聪不明，不能为王；不瞽不聋，不能为公。”本指公卿的度量，后常与“不成姑公”等连用，谓不故作痴呆，不装聋作哑，就不能当好阿婆阿公。意指长辈要宽宏大量。
不耻下问	bu'chi'xia'wen	向地位、学问不如自己的人虚心请教而不认为有失体面。
不偢不倸	bu'chou'bu'cai	①犹不理不睬。②指一切事情都不注意。
不瞅不睬	bu'chou'bu'cai	又作：不理睬。
不揣冒昧	bu'chuai'mao'mei	自谦之词。谓不自量，鲁莽无知。
不存不济	bu'cun'bu'ji	支持不住，受不住。
不打自招	bu'da'zi'zhao	①不用拷问，自己就招认了罪行。②比喻无意中暴露了自己的意图。
不得而知	bu'de'er'zhi	无从知道。
不得开交	bu'de'kai'jiao	同“不可开交”。
不得其所	bu'de'qi'suo	①《穀梁传·成公八年》：“媵，浅事也，不志。此其志何也？以伯姬之不得其所，故尽其事也。”范宁注：“不得其所，谓灾死也。”本指未得善终，后谓没有得到适当的安顿。②不能达到目的。
不得要领	bu'de'yao'ling	没有签订盟约或达成协议。语出《史记·大宛列传》：“骞从月氏至大夏，竟不能得月氏要领。”司马贞索隐引李奇云：“要领，要契也。”
不得要领	bu'de'yao'ling	①没有抓住关键或要点。②引伸为说话或行为同正题无关。
不登大雅	bu'deng'da'ya	见“不登大雅之堂”。
不动声色	bu'dong'sheng'se	①不说话，不流露感情。形容神态镇静。②形容轻易，不费气力。
不断如带	bu'duan'ru'dai	犹不绝如缕。
不二法门	bu'er'fa'men	佛家语。谓平等而无差异之至道。《维摩诘经·入不二法门品》：“如我意者，於一切法无言无说，无示无识，离诸问答，是为入不二法门。”南朝梁沈约《佛记序》：“廓不二之法门，广一乘之长陌。”唐裴漼《少林寺碑》：“空心、元粹、惠性、淹远，传不二法门，有甚深道业。”宋沈作喆《寓简》卷七：“三十一菩萨各说不二法门，至文殊独曰：‘无言说’。”后用以指独一无二的门径、方法。
不废江河	bu'fei'jiang'he	唐杜甫《戏为六绝句》之二：“王杨卢骆当时体，轻薄为文哂未休。尔曹身与名俱灭，不废江河万古流。”后以“不废江河”赞扬作家或其著作流传不朽。
不费之惠	bu'fei'zhi'hui	白白得到的好处。
不分青白	bu'fen'qing'bai	见“不分皁白”。
不分轩轾	bu'fen'xuan'zhi	车子前高后低叫轩，前低后高叫轾。谓不分高低上下。
不分玉石	bu'fen'yu'shi	谓无有区别，同归于尽。
不分皁白	bu'fen'zao'bai	《诗·大雅·桑柔》“匪言不能，胡斯畏忌”汉郑玄笺：“胡之言何也，贤者见此事之是非，非不能分别皁白言之於王也。”后以“不分皁白”谓不分黑白，不辨是非。
不丰不俭	bu'feng'bu'jian	见“不丰不杀”。
不丰不杀	bu'feng'bu'sha	不奢不俭，多少合宜。
不伏烧埋	bu'fu'shao'mai	①不服罪；不认错。②不听劝解。
不服水土	bu'fu'shui'tu	不能适应某地的气侯、饮食等。
不复堪命	bu'fu'kan'ming	无法再活下去。
不尴不尬	bu'gan'bu'ga	亦作“不猧不魀”。①又作：不明不白。②指人行为不正。③指处境困难。④指神色、态度不自然。
不根之谈	bu'gen'zhi'tan	没有根据的话。
不攻自破	bu'gong'zi'po	不用攻击，就自行溃败。多指情节或论点虚谬，经不起反驳。
不共戴天	bu'gong'dai'tian	谓不共存于人世间。喻仇恨极深。语出《礼记·曲礼上》：“父之雠，弗与共戴天。”
不苟言笑	bu'gou'yan'xiao	《礼记·曲礼上》：“不苟訾，不苟笑。”后以“不苟言笑”谓态度庄重。
不瞽不聋	bu'gu'bu'long	见“不痴不聋”。
不关紧要	bu'guan'jin'yao	不重要；不影响大局。
不关痛痒	bu'guan'tong'yang	比喻与本身利害无关或无足轻重。
不过尔尔	bu'guo'er'er	不过如此而已。
不寒而栗	bu'han'er'li	不冷而发抖。形容极为恐惧。
不寒而栗	bu'han'er'li	同“不寒而栗”。
不好意思	bu'hao'yi'si	①表示碍于情面而只能怎样或不便怎样。②害羞；难为情。
不合时宜	bu'he'shi'yi	不符合时势和趋尚。
不护细行	bu'hu'xi'xing	不注意小节。语本《书·旅獒》：“不矜细行，终累大德。”
不欢而散	bu'huan'er'san	不愉快地分手。
不慌不忙	bu'huang'bu'mang	从容不迫。
不遑枚举	bu'huang'mei'ju	犹不胜枚举。
不遑暇食	bu'huang'xia'shi	没有时间吃饭。形容工作紧张、辛勤。《书·无逸》：“自朝至於日中昃，不遑暇食，用咸和万民。”孔颖达疏：“遑亦暇也。重言之者，古人自有衤复语。犹云‘艰难’也。”一说，没有闲暇时间从容地吃饭。
不讳之朝	bu'hui'zhi'zhao	可直言不讳的朝代。谓政治清明之世。
不讳之路	bu'hui'zhi'lu	谓忠言直谏之路。
不讳之门	bu'hui'zhi'men	犹不讳之路。
不即不离	bu'ji'bu'li	①佛教语。谓诸法相状虽异而性体则一。②形容既不亲近，也不疏远。
不急之务	bu'ji'zhi'wu	无关紧要的事情；不急于做的事情。
不计其数	bu'ji'qi'shu	无法计算数目。形容很多。
不假思索	bu'jia'si'suo	用不着想，形容说话做事迅速。
不间不界	bu'jian'bu'jie	不尴不尬。左右为难，不好处理。
不见经传	bu'jian'jing'chuan	①经传上没有记载。②比喻没有来历或没有名气。
不见天日	bu'jian'tian'ri	①看不到天空和太阳。②常用以比喻政治黑暗，看不到光明。
不骄不躁	bu'jiao'bu'zao	不骄傲，不急躁。
不教而诛	bu'jiao'er'zhu	事先不进行教育，就加以惩罚。语本《论语·尧曰》：“不教而杀谓之虐。”
不解之缘	bu'jie'zhi'yuan	指难以解除的密切关系。
不矜细行	bu'jin'xi'xing	不注重小事小节。
不近道理	bu'jin'dao'li	不近人情，不讲道理。
不近人情	bu'jin'ren'qing	不合乎人之常情。
不禁不由	bu'jin'bu'you	不由自主。
不经之说	bu'jing'zhi'shuo	同“不经之谈”。
不经之谈	bu'jing'zhi'tan	荒诞或没有根据的话。
不经之语	bu'jing'zhi'yu	同“不经之谈”。
不胫而走	bu'jing'er'zou	汉孔融《论盛孝章书》：“珠玉无踁而自至者，以人好之也，况贤者之有足乎？“踁，同“胫”，小腿。后以“不胫而走”形容事物传布迅速，风行一时。
不揪不扌采	bu'jiu'bu'shou'cai		不理睬。
不咎既往	bu'jiu'ji'wang	语出《论语·八佾》：“成事不说，遂事不谏，既往不咎。”谓对以往的过错不再责备。
不拘细节	bu'ju'xi'jie	不拘小节。
不拘细行	bu'ju'xi'xing	不拘小节。
不拘小节	bu'ju'xiao'jie	谓待人处世不拘泥于小事。后多指不注意生活小事。
不拘形迹	bu'ju'xing'ji	形容言谈举止无拘无束，自由自在。
不拘一格	bu'ju'yi'ge	不局限于一个规格、标准。
不绝如带	bu'jue'ru'dai	同“不绝如线”。
不绝如发	bu'jue'ru'fa	同“不绝如线”。
不绝如缕	bu'jue'ru'lv	见“不绝如线”。
不绝如线	bu'jue'ru'xian	亦作“不绝如缕”。①形容局势危急，象差点兒就要断掉的线一样。②形容子孙衰落或后继者稀少。③形容声音或思绪微弱。
不绝若线	bu'jue'ruo'xian	见“不绝如线”。
不觉技痒	bu'jue'ji'yang	谓具有某种技能的人，一遇机会，便情不自禁地想表现一下。语本汉应劭《风俗通·声音·筑》：“渐离变名易姓，为人庸保，匿作於宋子，久之，作苦，闻其家堂上客击筑，伎痒，不能毋出言，曰：‘彼有善不善。’”
不刊之论	bu'kan'zhi'lun	亦作“不刊之说”。不可改易之论，确论。
不刊之说	bu'kan'zhi'shuo	见“不刊之论”。
不堪回首	bu'kan'hui'shou	谓不忍心回忆过去。
不堪入耳	bu'kan'ru'er	形容言语十分粗野难听。
不堪入目	bu'kan'ru'mu	形容行为卑鄙或东西粗劣，不值得一看。
不堪设想	bu'kan'she'xiang	不能想象。指事情会发展到很危险的地步。
不堪一击	bu'kan'yi'ji	经不起一次打击。形容十分脆弱。
不堪造就	bu'kan'zao'jiu	谓没有培养前途。
不亢不卑	bu'kang'bu'bei	亦作“不抗不卑”。不高傲，也不自卑。形容对人的态度或言语得体。
不抗不卑	bu'kang'bu'bei	见“不亢不卑”。
不可多得	bu'ke'duo'de	稀少，难得。
不可告人	bu'ke'gao'ren	无法或不能告诉别人。多指难言之隐。有时含贬义。
不可救疗	bu'ke'jiu'liao	见“不可救药”。
不可救药	bu'ke'jiu'yao	病重到没有药可以医治，比喻事态已严重到无法挽救。
不可开交	bu'ke'kai'jiao	形容无法解脱。
不可理喻	bu'ke'li'yu	无法跟他讲道理。形容态度蛮横。
不可枚举	bu'ke'mei'ju	无法一个个列举。形容数量之多。
不可名状	bu'ke'ming'zhuang	无法用言辞形容。
不可摸捉	bu'ke'mo'zhuo	见“不可捉摸”。
不可磨灭	bu'ke'mo'mie	无法使之消失。
不可奈何	bu'ke'nai'he	犹无可奈何。表示没有办法。
不可胜道	bu'ke'sheng'dao	无法尽说。极言其多。
不可胜计	bu'ke'sheng'ji	见“不可胜数”。
不可胜记	bu'ke'sheng'ji	见“不可胜纪”。
不可胜纪	bu'ke'sheng'ji	亦作“不可胜记”。不能逐一记述。极言其多。
不可胜举	bu'ke'sheng'ju	无法一一枚举，极言其多。
不可胜数	bu'ke'sheng'shu	不计其数。极言其多。
不可胜算	bu'ke'sheng'suan	见“不可胜数”。
不可胜言	bu'ke'sheng'yan	犹不可胜道。形容数量多。
不可收拾	bu'ke'shou'shi	①谓无法整顿。②形容事情坏到不可挽回的地步。
不可思议	bu'ke'si'yi	①佛家语。指思维和言语所不能达到的微妙境界。道教也借用此语。②形容事物无法想象或难以理解。
不可乡迩	bu'ke'xiang'er	亦作“不可向迩”。不可接近。
不可乡迩	bu'ke'xiang'er	亦作“不可向迩”。不可接近。
不可向迩	bu'ke'xiang'er	见“不可乡迩”。
不可言喻	bu'ke'yan'yu	无法用言辞表达。
不可言状	bu'ke'yan'zhuang	同“不可名状”。
不可一世	bu'ke'yi'shi	①谓自视甚高，对天下人极少赞许推重。可，称是。②骄横自大。
不可终日	bu'ke'zhong'ri	一天也过不下去。形容局势危急或心中惶恐。语出《礼记·表记》：“君子不以一日使其躬，儳焉如不终日。”
不可捉摸	bu'ke'zhuo'mo	亦作“不可摸捉”。形容难以猜测或估量。
不媿下学	bu'kui'xia'xue	又作：不耻下问。
不愧屋漏	bu'kui'wu'lou	《诗·大雅·抑》：“相在尔室，尚不愧于屋漏。”毛传：“西北隅谓之屋漏。”郑玄笺：“屋，小帐也；漏，隐也。”原谓独处于室时，亦慎守善德，使无愧于心。后转谓心地光明，在幽暗之处也不起邪念、做坏事。
不郎不秀	bu'lang'bu'xiu	①明代俗语。又作：不高不下。②用以比喻不成材或没出息。参见“不稂不莠”。
不稂不莠	bu'lang'bu'you	《诗·小雅·大田》：“既坚既好，不稂不莠。”硃熹集传：“稂，童粱；莠，似苗。皆害苗之草也。”本谓田中没有野草。后以喻不成材或没出息。
不劳而成	bu'lao'er'cheng	不须劳苦就能有成就。
不劳而获	bu'lao'er'huo	自己不劳动而占有别人劳动的成果。
不立文字	bu'li'wen'zi	佛教禅宗主顿悟，以心传心，不涉文字语言，谓之不立文字。
不凉不酸	bu'liang'bu'suan	方言。形容态度冷漠。
不了不当	bu'liao'bu'dang	又作：拖泥带水，没有了结。
不了而了	bu'liao'er'liao	犹不了了之。
不了了之	bu'liao'liao'zhi	把未了的事情放在一边不去管它，就算完事。
不劣方头	bu'lie'fang'tou	倔强不驯。不劣，不驯顺；方头，指为人不圆通。
不磷不缁	bu'lin'bu'zi	磨不薄，染不黑。比喻坚贞高洁的品质，不因外界影响而有所改变。语本《论语·阳货》：“不曰坚乎，磨而不磷。不曰白乎，涅而不缁。”何晏集解引孔安国曰：“言至坚者磨而不薄，至白者染之於涅而不黑。君子虽在浊乱，浊乱不能污。”
不露锋铓	bu'lu'feng'mang	比喻才干不外露。
不露圭角	bu'lu'gui'jiao	《礼记·儒行》“毁方而瓦合”汉郑玄注：“去己之大圭角，下与众小人合也。”孔颖达疏：“圭角谓圭之锋铓有楞角。言儒者身恆方正，若物有圭角；不欲异众过甚，去其大圭角，言犹有小圭角也。”后因以“不露圭角”谓深沉不露锋芒。
不露声色	bu'lu'sheng'se	不让心里的打算从话音和脸色上流露出来。
不露形色	bu'lu'xing'se	不让思想活动从行动和表情上流露出来。
不伦不类	bu'lun'bu'lei	既不象这一类，也不象那一类。形容不成样子或不规范。
不落边际	bu'luo'bian'ji	同“不着边际”。
不落窠臼	bu'luo'ke'jiu	不落俗套。比喻有独创风格。
不落俗套	bu'luo'su'tao	不因袭陈旧的格式。
不蔓不支	bu'wan'bu'zhi	见“不蔓不枝”。
不蔓不枝	bu'wan'bu'zhi	宋周敦颐《爱莲说》：“中通外直，不蔓不枝。”原指莲茎直而无分枝蔓生，后用以比喻言谈或文章简洁明快，不拖泥带水。
不忙不暴	bu'mang'bu'bao	犹不忙不急。
不名一格	bu'ming'yi'ge	同“不拘一格”。
不名一钱	bu'ming'yi'qian	没有一文钱，形容极其贫困。名，占有。
不名一文	bu'ming'yi'wen	见“不名一钱”。
不明不白	bu'ming'bu'bai	①暖昧，不能公开。②又作：无缘无故。
不谋而合	bu'mou'er'he	没有经过商量而见解一致。
不谋同辞	bu'mou'tong'ci	事前没有商量而意见完全一致。
不奈之何	bu'nai'zhi'he	无可奈何，无法可想。
不挠不屈	bu'nao'bu'qu	同“不屈不挠”。
不挠不折	bu'nao'bu'zhe	不弯曲，不屈服。形容节操刚正，意志坚强。
不能自拔	bu'neng'zi'ba	自己无法摆脱。
不念旧恶	bu'nian'jiu'e	不记过去的仇怨。
不宁唯是	bu'ning'wei'shi	不仅如此。
不偏不党	bu'pian'bu'dang	形容公正，不偏袒。
不偏不倚	bu'pian'bu'yi	①《礼记·中庸》宋硃熹题解：“中者，不偏不倚，无过不及之名。”原谓中庸之道适得其中而无偏颇之弊，后常用于指不偏袒任何一方。②指位置准确，没有偏差。
不平则鸣	bu'ping'ze'ming	谓遇到不公正的待遇，就要发出不满的呼声。语出唐韩愈《送孟东野序》：“大凡物不得其平则鸣。”
不破不立	bu'po'bu'li	谓旧的不破除，新的就不能建立起来。
不期而会	bu'qi'er'hui	①未经约定而意外地遇见。②未经约定而自动聚集。
不期而然	bu'qi'er'ran	见“不期然而然”。
不期而同	bu'qi'er'tong	不约而同。
不期而遇	bu'qi'er'yu	同“不期而会”。
不欺闇室	bu'qi'an'shi	见“不欺暗室”。
不欺暗室	bu'qi'an'shi	亦作“不欺闇室”。汉刘向《列女传·卫灵夫人》：“灵公与夫人夜坐闻车声辚辚，至阙而止，过阙复有声。公问夫人，曰：‘知此谓谁？’夫人曰：‘此蘧伯玉也。’公曰：‘何以知之！’夫人曰：‘妾闻礼下公门，式路马，所以广敬也。夫忠臣与孝子不为昭昭信节，不为冥冥堕行。蘧伯玉，卫之贤大夫也，仁而有智，敬以事上，此其人必不以闇昧废礼，是以知之。’公使视之，果伯玉也。”后因以“不欺暗室”谓在无人看见的地方，也不作昧心事。
不欺屋漏	bu'qi'wu'lou	同“不愧屋漏”。
不迁之庙	bu'qian'zhi'miao	古代不迁入祧庙合祭而单独进行祭祀的帝王家庙。
不乾不净	bu'qian'bu'jing	①指粗俗，下流。②淫乱的婉词。
不勤而获	bu'qin'er'huo	不劳而获。
不情之请	bu'qing'zhi'qing	不合情理的请求。提出请求时用的套语。
不求甚解	bu'qiu'shen'jie	晋陶潜《五柳先生传》：“不慕利，好读书，不求甚解，每有会意，欣然忘食。”意谓读书只求领会要旨，不刻意在字句上花工夫。今多谓对待学习、工作不认真，不求深入理解。
不屈不挠	bu'qu'bu'nao	形容顽强斗争，在敌人或困难面前不屈服，不低头。语本《汉书·叙传下》：“乐昌笃实，不桡不诎。”
不染一尘	bu'ran'yi'chen	同“一尘不染”。形容清高廉洁。
不容分说	bu'rong'fen'shuo	不允许分辩陈说。
不容置疑	bu'rong'zhi'yi	不容许有什么怀疑。
不辱使命	bu'ru'shi'ming	谓不辜负别人的差使。
不入时宜	bu'ru'shi'yi	见“不合时宜”。
不三不四	bu'san'bu'si	①不伦不类。②指行为不端，不正派。
不僧不俗	bu'seng'bu'su	又作：不三不四，不伦不类。
不衫不履	bu'shan'bu'lv	衣著不整齐。形容性情洒脱，不拘小节。
不伤脾胃	bu'shang'pi'wei	比喻无关痛痒。
不赏之功	bu'shang'zhi'gong	《史记·淮阴侯列传》：“臣闻勇略震主者身危，而功盖天下者不赏。”后以“不赏之功”极言功大。
不上不落	bu'shang'bu'luo	见“不上不下”。
不上不下	bu'shang'bu'xia	①亦作“不上不落”。形容事情无着落，处境为难。②不好不坏。
不甚了了	bu'shen'liao'liao	①不大明白事理。②泛指不大清楚。
不声不吭	bu'sheng'bu'hang	同“不声不响”。
不声不气	bu'sheng'bu'qi	见“不声不响”。
不声不响	bu'sheng'bu'xiang	不说话；不出声。
不胜桮杓	bu'sheng'bei'shao	谓酒量有限，不能再饮。桮杓，酒具，借指饮酒。
不胜枚举	bu'sheng'mei'ju	无法一一全举出来，形容为数极多。
不胜其烦	bu'sheng'qi'fan	烦琐得使人受不了。
不省人事	bu'sheng'ren'shi	昏迷过去，失去知觉。
不失黍絫	bu'shi'shu'lei	又作：丝毫不差。絫、黍，微小的重量。
不时之须	bu'shi'zhi'xu	不时之需。谓随时的、不是预定时间的需要。
不识不知	bu'shi'bu'zhi	①谓不识古今。形容古代民风淳朴。②犹不知不觉。
不识东家	bu'shi'dong'jia	“不识东家丘”的略语。相传孔子西家有愚夫，不识孔子为圣人，称之为“东家丘”，后以“不识东家”谓不识近邻是圣贤。
不识好歹	bu'shi'hao'dai	不知好坏。谓愚蠢，缺乏识别能力。
不识局面	bu'shi'ju'mian	犹不识时务。
不识起倒	bu'shi'qi'dao	不知好歹；不识时务。
不识时务	bu'shi'shi'wu	不了解当前的情势或潮流。
不识抬举	bu'shi'tai'ju	指责别人不理解或不珍视自己对他的优待或礼遇。
不识泰山	bu'shi'tai'shan	比喻没有见识，不知礼敬大人物。多用于“有眼”之后。
不识一丁	bu'shi'yi'ding	不识一个字。形容人不识字或文化水平低。
不识之无	bu'shi'zhi'wu	唐白居易《与元九书》：“仆始生六七月时，乳母抱弄於书屏下，有指‘无’字、‘之’字示仆者，仆虽口未能言，心已默识。”后以“不识之无”形容人不识字，文化水平很低。
不食烟火	bu'shi'yan'huo	①指不吃熟食。道家修炼主张绝粒却谷，不吃世间烟火物。②谓诗文立意高超，言词清丽，不同凡俗。
不食周粟	bu'shi'zhou'su	《史记·伯夷列传》：“武王已平殷乱，天下宗周，而伯夷、叔齐耻之，义不食周粟，隐於首阳山，采薇而食之。”后以“不食周粟”谓清白守节。
不事边幅	bu'shi'bian'fu	不修边幅。
不爽毫发	bu'shuang'hao'fa	没有一点差错。
不爽累黍	bu'shuang'lei'shu	见“不失黍絫”。
不死不活	bu'si'bu'huo	形容事物无生气的状态。
不速之客	bu'su'zhi'ke	没有邀请而自己来的客人。
不祧之宗	bu'tiao'zhi'zong	见“不祧之祖”。
不祧之祖	bu'tiao'zhi'zu	不迁入祧庙的祖先，一般指创业之祖。常用以比喻创立某种事业永远受到尊崇的人。
不同戴天	bu'tong'dai'tian	同“不共戴天”。
不同凡响	bu'tong'fan'xiang	不正常，杰出。凡响，平凡的音乐。
不痛不痒	bu'tong'bu'yang	①比喻不中肯，未触及要害，或不能彻底解决问题。②又作：麻木不仁。
不吐不茹	bu'tu'bu'ru	《诗·大雅·烝民》：“人亦有言，柔则茹之，刚则吐之。维仲山甫，柔亦不茹，刚亦不吐，不侮矜寡，不畏彊御。”后以“不吐不茹”形容人正直不阿，不欺软怕硬。
不为已甚	bu'wei'yi'shen	《孟子·离娄下》：“仲尼不为已甚者。”硃熹集注：“已，犹太也。杨氏曰：‘言圣人所为，本分之外，不加毫末。’”后以“不为已甚”谓不做过分的事，适可而止。
不违农时	bu'wei'nong'shi	不误耕作季节。
不闻不问	bu'wen'bu'wen	①不听也不问。②谓不关心，不过问。
不问不闻	bu'wen'bu'wen	不问也不听。形容因某种原因对周围事物很淡漠。
不问皁白	bu'wen'zao'bai	同“不分皁白”。
不猧不魀	bu'wo'bu'ga	见“不尴不尬”。
不舞之鹤	bu'wu'zhi'he	南朝宋刘义庆《世说新语·排调》：“昔羊叔子有鹤善舞，尝向客称之。客试使驱来，氃氋不肯舞。”后因以“不舞之鹤”喻名不副实。
不务正业	bu'wu'zheng'ye	谓不从事正当的营生或职业。也指丢下本职工作不做，而去搞其他事情。
不習地土	bu'xi'di'tu	见“不服水土”。
不習水土	bu'xi'shui'tu	见“不服水土”。
不咸不淡	bu'xian'bu'dan	①平平淡淡；普普通通。②指冷言嘲笑。
不相上下	bu'xiang'shang'xia	分不出高低。形容程度相等。
不相为谋	bu'xiang'wei'mou	不互相商议。
不晓世务	bu'xiao'shi'wu	同“不识时务”。
不屑一顾	bu'xie'yi'gu	形容对某事物异常鄙视，认为不值得一看。
不修边幅	bu'xiu'bian'fu	亦作“不脩边幅”。《后汉书·马援传》：“公孙不吐哺走迎国士，与图成败，反修饰边幅，如偶人形。此子何足久稽天下士乎？”李贤注：“言若布帛脩整其边幅也。”后形容不讲究服饰、仪表为不修边幅。
不修小节	bu'xiu'xiao'jie	同“不拘小节”。
不脩边幅	bu'xiu'bian'fu	见“不修边幅”。
不学无识	bu'xue'wu'shi	没有学问，缺乏见识。
不学无术	bu'xue'wu'shu	《汉书·霍光传赞》：“然光不学亡术，闇於大理。”亡，通“无”。本谓霍光不能学古，故所行不合于道术。后用以泛指缺乏学问、本领。
不言而谕	bu'yan'er'yu	见“不言而喻”。
不言而喻	bu'yan'er'yu	亦作“不言而谕”。不用说就可明白。形容事理极其显明。
不厌其烦	bu'yan'qi'fan	不嫌烦琐；不嫌麻烦。
不厌其繁	bu'yan'qi'fan	同“不厌其烦”。
不厌其详	bu'yan'qi'xiang	不嫌详细。
不一而足	bu'yi'er'zu	亦作“不壹而足”。不是一事一物可以满足。《公羊传·文公九年》：“始有大夫，则何以不氏？许夷狄者，不一而足也。”《汉书·陈汤传》：“御使大夫财禹、博士匡衡以为《春秋》之义‘许夷狄者，不壹而足’，今郅支单于乡化未醇，所在绝远，宜令使者送其子至塞而还。”颜师古注：“言节制之，不皆称其所求也。”后用以表示所言事物不能尽举。
不壹而三	bu'yi'er'san	再三；多次。
不壹而足	bu'yi'er'zu	见“不一而足”。
不遗巨细	bu'yi'ju'xi	连极细小处也不放过。
不遗馀力	bu'yi'yu'li	谓毫无保留地使出全部力量。
不以为耻	bu'yi'wei'chi	不以此作为耻辱。
不以为奇	bu'yi'wei'qi	不感到奇怪。
不以为然	bu'yi'wei'ran	不认为是正确的。多用于表示不同意。
不以为意	bu'yi'wei'yi	不把事情放在心上。
不义之财	bu'yi'zhi'cai	不应得的或来路不正的钱财。
不亦乐乎	bu'yi'le'hu	《论语·学而》：“有朋自远方来，不亦乐乎！”意谓不也是很快乐的吗！后常用以表示事态发展已达到极度，兼有淋漓尽致之意。
不易之论	bu'yi'zhi'lun	不可改变的定论。
不翼而飞	bu'yi'er'fei	①形容运行或传播迅速。语本《管子·戒》：“无翼而飞者，声也；无根而固者，情也。”②比喻东西突然消失。
不因不由	bu'yin'bu'you	又作：无意之中。
不因人热	bu'yin'ren're	《东观汉记·梁鸿传》：“（鸿）常独坐止，不与人同食。比舍先炊已，呼鸿及热釜炊。鸿曰：‘童子鸿，不因人热者也。’灭灶更燃火。”后因称不仰仗别人为“不因人热”。
不阴不阳	bu'yin'bu'yang	比喻态度暖昧不明。
不由分说	bu'you'fen'shuo	不容分辩。
不由自主	bu'you'zi'zhu	由不得自己作主，谓无法控制自己。
不虞之誉	bu'yu'zhi'yu	意想不到的赞扬。
不约而同	bu'yue'er'tong	《史记·平津侯主父列传》：“无尺寸之势，起闾巷，杖棘矜，应时而皆动，不谋而俱起，不约而同会。”后以“不约而同”谓没有经过商量或约定而彼此的看法或行动完全一致。
不在话下	bu'zai'hua'xia	①小说戏曲中套语，表示此处不用详细叙说。②指事物轻微，不值得提，或不成问题。
不赞一词	bu'zan'yi'ci	《史记·孔子世家》：“至於为《春秋》，笔则笔，削则削，子夏之徒，不能赞一辞。”原谓文章写得很好，别人不能再添一句话，后用为一言不发之意。
不择生冷	bu'ze'sheng'leng	又作：不择手段。
不择手段	bu'ze'shou'duan	为了达到目的，什么手段都使得出来。
不折不扣	bu'zhe'bu'kou	①不打折扣。原为商业用语，商品照标价减去若干成数出售，叫做打折扣。②表示完全、十足的意思。
不知不觉	bu'zhi'bu'jue	不经意，无意之间。
不知颠倒	bu'zhi'dian'dao	又作：不晓事。
不知凡几	bu'zhi'fan'ji	不知道有多少，表示同类的人或事物很多。
不知甘苦	bu'zhi'gan'ku	①不知道甜味与苦味。②指对事情的艰难缺乏体会。
不知高低	bu'zhi'gao'di	①又作：不管好歹。②谓说话或做事不知轻重。③不知究竟，不明内情。
不知高下	bu'zhi'gao'xia	谓说话做事不知轻重。
不知好歹	bu'zhi'hao'dai	不辨好坏。也指不能领会别人的好意。
不知进退	bu'zhi'jin'tui	形容鲁莽，言语行动没有分寸。
不知就里	bu'zhi'jiu'li	不了解内情。
不知利害	bu'zhi'li'hai	《庄子·齐物论》：“齧缺曰：‘子不知利害，则至人固不知利害乎？’”谓不知何者为利，何者为害。今语“不知利害”出此。
不知起倒	bu'zhi'qi'dao	不知利害，不知高低。
不知寝食	bu'zhi'qin'shi	又作：废寝忘食。形容异常专心、努力。
不知轻重	bu'zhi'qing'zhong	谓不明事理，行事冒昧。
不知深浅	bu'zhi'shen'qian	①不明白水的深浅的程度。②常用以比喻说话或做事没有分寸。
不知死活	bu'zhi'si'huo	谓不知利害，冒昧从事。
不知所出	bu'zhi'suo'chu	①不知道从哪里来的。②不知道该怎么办。
不知所厝	bu'zhi'suo'cuo	同“不知所措”。
不知所措	bu'zhi'suo'cuo	语本《论语·子路》：“则民无所措手足。”形容不知道该怎么办才好。
不知所错	bu'zhi'suo'cuo	同“不知所措”。
不知所可	bu'zhi'suo'ke	不知道该怎么办才好。
不知所以	bu'zhi'suo'yi	不明白什么原因。
不知所云	bu'zhi'suo'yun	《文选·诸葛亮〈出师表〉》：“临表涕泣，不知所云。”《三国志·蜀志·诸葛亮传》作“不知所言”。本为谦词，谓自己思绪紊乱，不知道说了些什么。今泛指言语混乱或空洞。
不知疼痒	bu'zhi'teng'yang	见“不知痛痒”。
不知痛痒	bu'zhi'tong'yang	形容麻木不仁或不知利害。
不知头脑	bu'zhi'tou'nao	犹不知所措。
不直一钱	bu'zhi'yi'qian	亦作“不值一钱”。鄙视之词，又作：毫无价值。比喻无能或品格卑下。
不直一文	bu'zhi'yi'wen	同“不直一钱”。
不值一钱	bu'zhi'yi'qian	见“不直一钱”。
不值一笑	bu'zhi'yi'xiao	比喻毫无价值。
不忮不求	bu'zhi'bu'qiu	不嫉妒，不贪求。
不治之症	bu'zhi'zhi'zheng	治不好的病，绝症。
不置可否	bu'zhi'ke'fou	不表示同意，也不表示反对。
不主故常	bu'zhu'gu'chang	不拘守旧套常规。
不追既往	bu'zhui'ji'wang	见“不咎既往”。
不着疼热	bu'zhuo'teng're	又作：无关痛痒。
不自满假	bu'zi'man'jia	不自满，不自大。
不足齿数	bu'zu'chi'shu	不足以相提并论，同等看待。
不足挂齿	bu'zu'gua'chi	不值得一提。语出《汉书·叔孙通传》：“此特群盗鼠窃狗盗，何足置齿牙间哉？”
不足轻重	bu'zu'qing'zhong	又作：无关紧要。
不足为法	bu'zu'wei'fa	不值得学习、效法。
不足为据	bu'zu'wei'ju	不能作为凭据。
不足为凭	bu'zu'wei'ping	不足为据。
不足为奇	bu'zu'wei'qi	不值得奇怪。
不足为训	bu'zu'wei'xun	不值得作为遵循的准则。
不足为意	bu'zu'wei'yi	不值得介意。
不做不休	bu'zuo'bu'xiu	谓事情既然开了头，就索性干到底。
不@手药	bu'@'shou'yao	①使手不冻裂的药。②比喻微才薄技。
布被瓦器	bu'bei'wa'qi	寝以布被，食以瓦器。形容生活俭朴。
布帆无恙	bu'fan'wu'yang	亦作“布颿无恙”。南朝宋刘义庆《世说新语·排调》：“顾长康作殷荆州佐，请假还东。尔时例不给布颿，顾苦求之，乃得发；至破冢，遭风，大败。作笺与殷云：‘地名破冢，真破冢而出，行人安稳，布颿无恙。’”后遂以“布帆无恙”为旅途平安之典。
布颿无恙	bu'fan'wu'yang	见“布帆无恙”。
布天盖地	bu'tian'gai'di	形容数量极多，散布面极广。
布衣韦带	bu'yi'wei'dai	亦省作“布韦”。①贫寒之士的服饰。②借指贫寒的或没有做官的文士。
步步生莲华	bu'bu'sheng'lian'hua		语本《杂宝藏经·鹿女夫人缘》故事，谓鹿女每步迹有莲花，后为梵豫国王第二夫人，生千叶莲花，一叶有一小兒，得千子，为贤劫千佛。南齐东昏侯萧宝卷因以在宫中为其宠妃潘玉兒造金莲贴地，令潘步其上，称之谓“步步生莲华”。
步步为营	bu'bu'wei'ying	指军队前进一步就设下一道营垒。
步罡踏斗	bu'gang'ta'dou	道士礼拜星宿、召遣神灵的一种动作。其步行转折，据说宛如踏在罡星斗宿之上，故称。
擦拳磨掌	ca'quan'mo'zhang	见“擦掌磨拳”。
擦掌磨拳	ca'zhang'mo'quan	形容准备动武，准备动手干或焦灼不安的样子。
擦脂抹粉	ca'zhi'mo'fen	又作：涂脂抹粉。
才高八斗	cai'gao'ba'dou	宋无名氏《释常谈·八斗之才》：“文章多谓之八斗之才，谢灵运尝曰：‘天下才有一石，曹子建独占八斗，我得一斗，天下共分一斗。’”后因以“才高八斗”形容富于文才。
才高七步	cai'gao'qi'bu	南朝宋刘义庆《世说新语·文学》：“文帝（曹丕）尝令东阿王（丕弟曹植）七步中作诗，不成者行大法；应声便为诗曰：‘煮豆持作羹，漉豉以为汁；箕在釜下燃，豆在釜中泣。本自同根生，相煎何太急！’”后因以“才高七步”形容才思敏捷。
才高气清	cai'gao'qi'qing	谓才能高超而气质清峻。
才高行洁	cai'gao'xing'jie	才能超群，品行高洁。
才貌双全	cai'mao'shuang'quan	才能外貌俱佳。
才墨之薮	cai'mo'zhi'sou	谓文人聚集的地方。
才疏学浅	cai'shu'xue'qian	才识不广，学问浅薄。多用作自谦词。
才疏意广	cai'shu'yi'guang	抱负远大而才能不高。
才疏志大	cai'shu'zhi'da	南朝宋刘义庆《世说新语·识鉴》：“伯仁为人志大而才短，名重而识暗。”后以“才疏志大”谓志向大而才能小。
才讠夸八斗	cai'yan'kua'ba'dou		夸耀才华出众。
才子佳人	cai'zi'jia'ren	称有才貌的青年男女。
材薄质衰	cai'bao'zhi'shuai	谓才情资质薄弱。有时用为谦词。
材大难用	cai'da'nan'yong	《庄子·逍遥游》：“惠子谓庄子曰：‘吾有大树，人谓之樗。其大本拥肿而不中绳墨，其小枝卷曲而不中规矩，立之涂，匠者不顾。今子之言，大而无用，众所同去也。’庄子曰：‘子独不见狸狌乎？卑身而伏，以候敖者；东西跳梁，不避高下；中於机辟，死於罔罟。今夫斄牛，其大若垂天之云。此能为大矣，而不能执鼠。今子有大树，患其无用，何不树之於无何有之乡，广莫之野，彷徨乎无为其侧，逍遥乎寝卧其下，不夭斤斧，物无害者。无所可用，安所困苦哉！’”本谓高才难用于小事。后多谓怀才不遇。
材高知深	cai'gao'zhi'shen	才智高超，识见深广。
材剧志大	cai'ju'zhi'da	才智多，志向大。
材茂行絜	cai'mao'xing'xie	才智丰茂，行为廉洁。
材轻德薄	cai'qing'de'bao	才德疏浅。有时用为谦词。
材士练兵	cai'shi'lian'bing	又作：勇士精兵。
材疏志大	cai'shu'zhi'da	谓志向虽大而才能不足。有时用为谦词。
材雄德茂	cai'xiong'de'mao	谓才德杰出。
材朽行秽	cai'xiu'xing'hui	谓无才无德。有时用为谦词。
材优幹济	cai'you'gan'ji	谓才能优异，有干练的办事能力。
财大气粗	cai'da'qi'cu	①谓富有财产，气派不凡。②指仗着钱财多而气势凌人。
财殚力竭	cai'dan'li'jie	见“财竭力尽”。
财殚力尽	cai'dan'li'jin	见“财竭力尽”。
财竭力尽	cai'jie'li'jin	谓财力用尽。形容陷入困境。
财匮力绌	cai'kui'li'chu	谓钱财缺乏，力量不足。
财迷心窍	cai'mi'xin'qiao	谓由于一心爱财而心中糊涂。
财运亨通	cai'yun'heng'tong	旧指发财的运气好，赚钱很顺利。
裁长补短	cai'chang'bu'duan	又作：取长补短。
裁红点翠	cai'hong'dian'cui	①采摘花卉。②比喻选择华丽的辞藻。
裁心镂舌	cai'xin'lou'she	形容用尽心思，费尽口舌。
裁云翦水	cai'yun'jian'shui	裁行云，剪流水。比喻诗文构思精妙新巧。
采笔生花	cai'bi'sheng'hua	犹梦笔生花。五代王仁裕《开元天宝遗事·梦笔头生花》载，唐代大诗人李白曾梦见所用之笔，头上生花。从此才情横溢，文思丰富。后遂以此喻才思大进。
采风问俗	cai'feng'wen'su	采集歌谣，访问风俗。
采葑采菲	cai'feng'cai'fei	喻不因其所短而舍其所长。
采凤随鸦	cai'feng'sui'ya	比喻才貌出众的女子嫁给远不如自己的男人。
采凤随鸦	cai'feng'sui'ya	比喻才貌出众的女子嫁给远不如自己的男人。
采兰赠芍	cai'lan'zeng'shao	语本《诗·郑风·溱洧》：“士与女，方秉蕑兮……维士与女，伊其相谑，赠之以勺药。”毛传：“蕑，兰也。”后因以“采兰赠芍”比喻男女互赠物品表示相爱。旧亦视为淫佚之行。
采兰赠芍	cai'lan'zeng'shao	见“采兰赠药”。
采兰赠芍	cai'lan'zeng'shao	见“采兰赠药”。
采兰赠药	cai'lan'zeng'yao	谓男女互赠礼物以示爱慕。语本《诗·郑风·溱洧》：“士与女，方秉蕑兮。”毛传：“蕑，兰也。”又“维士与女，伊其相谑，赠之以勺药。”毛传：“勺药，香草”。
采薪之患	cai'xin'zhi'huan	见“采薪之忧”。
采薪之疾	cai'xin'zhi'ji	见“采薪之忧”。
采薪之疾	cai'xin'zhi'ji	见“采薪之忧”。
采薪之忧	cai'xin'zhi'you	《孟子·公孙丑下》：“昔者有王命，有采薪之忧，不能造朝。”硃熹集注：“采薪之忧，言病不能采薪。”后因以“采薪之忧”指患病。
采薪之忧	cai'xin'zhi'you	《孟子·公孙丑下》：“昔者有王命，有采薪之忧，不能造朝。”硃熹集注：“采薪之忧，言病不能采薪。”后因以“采薪之忧”指患病。
采薪之忧	cai'xin'zhi'you	自称有病的婉辞。
采衣娱亲	cai'yi'yu'qin	《艺文类聚》卷二十引《列女传》：相传春秋时楚国老莱子事亲至孝，年七十，常著五色斑斓衣，作婴兒戏。上堂，故意仆地，以博父母一笑。后遂用“采衣娱亲”为孝养父母之典。
彩凤随鸦	cai'feng'sui'ya	比喻淑女嫁鄙男。
彩云易散	cai'yun'yi'san	美丽的彩霞容易消散。比喻好景不长。
参差不齐	can'cha'bu'qi	不一致；不整齐。
参差错落	can'cha'cuo'luo	交错不齐。
参辰卯酉	can'chen'mao'you	①参、辰，二星名。参星酉时出于西方，辰星卯时出于东方。参与辰，卯与酉相对立，因用以比喻互不相关或势不两立。②犹是非曲直。
参辰日月	can'chen'ri'yue	见“参辰卯酉”。
参回斗转	can'hui'dou'zhuan	谓夜深。参，参星；斗，北斗星。
参前倚衡	can'qian'yi'heng	①《论语·卫灵公》：“子张问行，子曰：‘言忠信，行笃敬，虽蛮貊之邦，行矣。言不忠信，行不笃敬，虽州里，行乎哉？立则见其参於前也，在舆则见其倚於衡也，夫然后行。’子张书诸绅。”意谓言行要讲究忠信笃敬，站着就仿佛看见“忠信笃敬”四字展现于眼前，乘车就好象看见这几个字在车辕的横木上。②泛指一举一动，一切场合。
参天贰地	can'tian'er'di	见“参天两地”。
参天两地	can'tian'liang'di	①为《易》卦立数之义。②引申为人之德可与天地相比。
参伍错综	can'wu'cuo'zong	交互错杂。语本《易·系辞上》：“参伍以变，错综其数。”
骖风驷霞	can'feng'si'xia	谓仙道者云游四方。
骖鸾驭鹤	can'luan'yu'he	驾驭鸾凤仙鹤。喻成仙。
餐风沐雨	can'feng'mu'yu	吃的是风，洗的是雨。形容行旅或野外生活的艰苦。
餐风啮雪	can'feng'nie'xue	形容野外生活的艰苦。
餐风茹雪	can'feng'ru'xue	见“餐风啮雪”。
餐风宿草	can'feng'su'cao	同“餐风宿露”。
餐风宿露	can'feng'su'lu	形容旅途或野外生活的艰苦。
餐风宿水	can'feng'su'shui	形容旅途的辛苦。
餐风宿雨	can'feng'su'yu	同“餐风宿露”。
餐风咽露	can'feng'yan'lu	见“餐风饮露”。
餐风饮露	can'feng'yin'lu	亦作“餐风咽露”。又作：餐风宿露。
餐葩饮露	can'pa'yin'lu	吞食百花，吸饮露水。形容超尘脱俗的神仙生活。
餐松啖柏	can'song'dan'bai	以松柏的叶实充饥。形容修仙学道者超尘脱俗的生活。
餐松饮涧	can'song'yin'jian	食松实，饮涧水。谓过隐居生活。
餐霞漱瀣	can'xia'shu'xie	餐食日霞，吸饮沆瀣。指超尘脱俗的仙家生活。
餐霞吸露	can'xia'xi'lu	同“餐霞漱瀣”。
餐霞饮景	can'xia'yin'jing	餐食日霞，吞饮日光。指超尘脱俗，修炼成仙。
餐霞饮瀣	can'xia'yin'xie	同“餐霞漱瀣”。
餐霞饮液	can'xia'yin'ye	指修炼长生不老之术。
餐腥啄腐	can'xing'zhuo'fu	比喻追求功名利禄。语本《庄子·秋水》：“夫鹓雏，发於南海而飞於北海，非梧桐不止，非练实不食，非醴泉不饮。於是鸱得腐鼠，鹓雏过之，仰而视之曰：‘哧！’今子欲以子之梁国而哧我邪？”
餐云卧石	can'yun'wo'shi	指超脱尘世的隐逸生活。
残杯冷炙	can'bei'leng'zhi	①残剩的酒肉。②指权贵的施舍。
残编裂简	can'bian'lie'jian	犹残编断简。
残兵败将	can'bing'bai'jiang	指战败后剩馀的兵将。
残膏剩馥	can'gao'sheng'fu	见“残膏賸馥”。
残膏賸馥	can'gao'sheng'fu	犹馀泽。剩馀的美好事物。
残羹冷炙	can'geng'leng'zhi	犹残杯冷炙。
残花败柳	can'hua'bai'liu	喻指被蹂躏遗弃的女子。
残篇断简	can'pian'duan'jian	同“残编断简”。
残山剩水	can'shan'sheng'shui	亦作“残山賸水”。①零散的山水；明灭隐现的山水。②残破的山河。指亡国或经过丧乱后的土地、景物。
残山賸水	can'shan'sheng'shui	见“残山剩水”。
残渣馀孽	can'zha'yu'nie	比喻在消灭或淘汰过程中残存下来的坏人。
蚕丛鸟道	can'cong'niao'dao	指险绝的山路。
蚕绩蟹匡	can'ji'xie'kuang	《礼记·檀弓下》：“成人有其兄死而不为衰者，闻子皋将为成宰，遂为衰。成人曰：‘蚕则绩而蟹有匡，范则冠而蝉有緌，兄则死而子皋为之衰。’”郑玄注：“蚩兄死者，言其衰之不为兄死。如蟹有匡，蝉有緌；不为蚕之绩，范之冠也。”谓养蚕吐丝要筐，蟹壳似筐而与蚕筐无关。用以比喻弟弟虽穿孝而不是为了哥哥。后因以“蚕绩蟹匡”比喻名不副实。
蚕食鲸吞	can'shi'jing'tun	像蚕食桑叶，鲸吞食物。比喻侵占并吞。
惭凫企鹤	can'fu'qi'he	《庄子·骈拇》：“是故凫胫虽短，续之则忧；鹤胫虽长，断之则悲。故性长非所断，性短非所续，无所去忧也。”后以“惭凫企鹤”喻对自己的短处感到惭愧，而羡慕别人的长处。
惨不忍睹	can'bu'ren'du	面对悲惨情形不忍心看下去。
惨不忍闻	can'bu'ren'wen	谓凄惨得不忍心听下去。
惨不忍言	can'bu'ren'yan	不忍心把悲惨情形说出口。
惨淡经营	can'dan'jing'ying	见“惨澹经营”。
惨澹经营	can'dan'jing'ying	亦作“惨淡经营”。①原指作画前先用浅淡颜色勾勒轮廓，苦心构思，经营位置。南朝齐谢赫《古画品录》以经营位置为绘画六法之一。②引申指苦心谋划并从事某项事情。
惨绝人寰	can'jue'ren'huan	人世间再没有那样凄惨的。极言惨痛之甚。
惨绿愁红	can'lv'chou'hong	指经风雨摧残的绿叶红花。
惨绿年华	can'lv'nian'hua	风华正茂的青年时期。
惨绿少年	can'lv'shao'nian	唐张固《幽闲鼓吹》：“潘孟阳初为户部侍郎，太夫人忧惕，谓曰：‘以尔人材，而在丞郎之位，吾惧祸之必至也。’户部解喻再三，乃曰：‘不然，试会尔列，吾观之。’因徧招深熟者。客至，夫人垂帘视之，既罢会，喜曰：‘皆尔之俦也，不足忧矣，末座惨绿少年何人也？’答曰：‘补阙杜黄裳。’夫人曰：‘此人全别，必是有名卿相。’”宋钱易《南部新书》己、宋宋谠《唐语林·识鉴》、宋孔平仲《续世说·贤缓》均载有此事。本指穿淡绿衣衫的少年。后称风度翩翩的青年男子为“惨绿少年”，本此。
惨无人道	can'wu'ren'dao	残酷得失去了为人之道。极言其残暴而灭绝人性。
惨无人理	can'wu'ren'li	又作：惨无人道。
惨无天日	can'wu'tian'ri	又作：暗无天日。
惨雨酸风	can'yu'suan'feng	又作：凄风苦雨。指令人伤感的天气。亦以喻不安定的局势。
沧海横流	cang'hai'heng'liu	海水到处泛滥。比喻时世动乱不安。
沧海桑田	cang'hai'sang'tian	大海变成农田，农田变成大海。语本晋葛洪《神仙传·王远》：“麻姑自说云：‘接侍以来，已见东海三为桑田。’”后以“沧海桑田”比喻世事变化巨大。
沧海一鳞	cang'hai'yi'lin	大海中的一片鱼鳞。比喻非常渺小。
沧海一粟	cang'hai'yi'su	大海中的一颗谷子。比喻极其渺小。
沧海遗珠	cang'hai'yi'zhu	海中珍珠被收采者遗漏。比喻被埋没的人材或为人所忽视的珍品。
沧浪老人	cang'lang'lao'ren	《楚辞·渔父》：“渔父莞尔而笑，鼓枻而去。乃歌曰：‘沧浪之水清兮，可以濯吾缨；沧浪之水浊兮，可以濯吾足。’”后以“沧浪老人”指隐者、渔父。
苍狗白衣	cang'gou'bai'yi	犹白衣苍狗。喻事物变幻无常。
苍狗白云	cang'gou'bai'yun	见“苍狗白衣”。
藏锋敛锷	cang'feng'lian'e	比喻不露锋芒。锷，剑刃。
藏锋敛锐	cang'feng'lian'rui	同“藏锋敛锷”。
藏锋敛颖	cang'feng'lian'ying	同“藏锋敛锷”。
藏垢纳污	cang'gou'na'wu	包藏污垢。常以喻包容坏人坏事。语本《左传·宣公十五年》：“川泽纳汙，山薮藏疾，瑾瑜匿瑕，国君含垢，天之道也。”
藏龙卧虎	cang'long'wo'hu	北周庾信《同会河阳公新造山池聊得寓目》：“暗石疑藏虎，盘根似卧龙。”后以“藏龙卧虎”比喻潜藏着人才或不同寻常的人。
藏器待时	cang'qi'dai'shi	比喻怀才以等待施展的时机。器，用具，引申为才能。语本《易·系辞下》：“君子藏器於身，待时而动。”
藏头露尾	cang'tou'lu'wei	又作：藏头擫脑。
藏污纳垢	cang'wu'na'gou	见“藏垢纳污”。
藏之名山	cang'zhi'ming'shan	见“藏诸名山”。
藏诸名山	cang'zhu'ming'shan	语出汉司马迁《报任少卿书》：“仆诚以著此书，藏诸名山，传之其人，通邑大都，则仆偿前辱之责。”原谓将著作藏于书府，传之后人。后谓著作极有价值，能传之后世。
操刀必割	cao'dao'bi'ge	比喻行事应果断，及时而动。
操刀伤锦	cao'dao'shang'jin	《左传·襄公三十一年》：“子皮欲使尹何为邑。子产曰：‘少，未知可否。’子皮曰：‘愿，吾爱之，不吾叛也。使夫往而学焉，夫亦愈知治矣。’子产曰：‘不可。人之爱人，求利之也。今吾子爱人则以政，犹未能操刀而使割也，其伤实多。子之爱人，伤之而已，其谁敢求爱於子？……子有美锦，不使人学制焉。大官、大邑，身之所庇也，而使学者制焉，其为美锦不亦多乎？侨闻学而后入政，未闻以政学者也。若果行此，必有所害。’”后遂以“操刀伤锦”比喻不谙政事而出任官职必致败事。
操刀制锦	cao'dao'zhi'jin	喻出仕从政。
操斧伐柯	cao'fu'fa'ke	执斧砍伐斧柄。喻可就近取法。语出《诗·豳风·伐柯》：“伐柯伐柯，其则不远。”《中庸》引此文，硃熹集注：“柯，斧柄。则，法也……言人执柯伐木以为柯者，彼柯长短之法，在此柯耳。”
操戈入室	cao'ge'ru'shi	见“操矛入室”。
操戈同室	cao'ge'tong'shi	谓兄弟相残或内部纷争。
操觚染翰	cao'gu'ran'han	犹操觚。
操矛入室	cao'mao'ru'shi	语出《后汉书·郑玄传》：“时任城何休好《公羊》学，遂著《公羊墨守》、《左氏膏肓》、《穀梁废疾》。玄乃发《墨守》，针《膏肓》，起《废疾》。休见而叹曰：‘康成入吾室，操吾矛以伐我乎！’”后以“操矛入室”比喻深入了解对方，找出其纰漏，又以对方的论点来批驳对方。
操奇计赢	cao'qi'ji'ying	见“操奇逐赢”。
操奇逐赢	cao'qi'zhu'ying	指商贾居奇牟利。语本《汉书·食货志上》：“商贾大者积贮倍息，小者坐列贩卖，操其奇赢。”颜师古注：“奇赢，谓有馀财而蓄聚奇异之物也。”
操揉磨治	cao'rou'mo'zhi	又作：反复磨练。
操身行世	cao'shen'xing'shi	又作：立身处世。
操赢致奇	cao'ying'zhi'qi	见“操奇逐赢”。
操之过蹙	cao'zhi'guo'cu	又作：操之过急。语出《公羊传·庄公三十年》：“扞齐人伐山戎呴，此齐侯也，其称人何？贬。曷为贬？子司马子曰：‘盖以操之为已蹙矣！’”
操之过激	cao'zhi'guo'ji	处事过于激烈。
操之过急	cao'zhi'guo'ji	办事太急躁。
操之过切	cao'zhi'guo'qie	见“操之过急”。
草草了事	cao'cao'liao'shi	草率地把事情办完。
草长莺飞	cao'chang'ying'fei	南朝梁丘迟《与陈伯之书》：“暮春三月，江南草长，杂花生树，群莺乱飞。”后来多用“草长莺飞”形容江南春天的景色。
草腹菜肠	cao'fu'cai'chang	比喻毫无才学。亦用为谦词。
草间求活	cao'jian'qiu'huo	又作：苟安偷生。
草菅人命	cao'jian'ren'ming	视人命如草芥而任意摧残。
草芥人命	cao'jie'ren'ming	同“草菅人命”。
草庐三顾	cao'lu'san'gu	语本三国蜀诸葛亮《前出师表》：“先帝不以臣卑鄙，猥自枉屈，三顾臣於草庐之中，谘臣以当世之事。”汉末刘备欲得贤辅，曾三诣隆中，枉驾亮舍，虚心就教，历来引为礼贤下士的佳话。
草率收兵	cao'shuai'shou'bing	马马虎虎地了结军事。比喻做工作不负责任，草草了事。
草木皆兵	cao'mu'jie'bing	前秦主苻坚在淝水战败，与弟苻融登寿春城而望晋师，见阵容齐整，将士精锐，又北望八公山上草木，皆类人形，对苻融说：“此亦勍敌也，何谓少乎！”怃然有惧色。见《晋书·苻坚载记下》。《资治通鉴·晋孝武帝太元八年》作“又望八公山上草木，皆以为晋兵”。后因以“草木皆兵”形容惊恐万状，疑虑重重。
草蛇灰线	cao'she'hui'xian	比喻事物留下隐约可寻的线索和迹象。
草蛇灰线	cao'she'hui'xian	见“草蛇灰线”。
草薙禽狝	cao'ti'qin'xian	谓如刈割野草、搜捕禽兽似地予以歼灭。语出唐韩愈《送郑尚书序》：“至纷不可治，乃草薙而禽狝之，尽根株痛断乃止。”
草行露宿	cao'xing'lu'su	在草野中趕路，露天歇宿。形容行旅的艰辛或迫促。
策马飞舆	ce'ma'fei'yu	谓驾马车疾行。
策名就列	ce'ming'jiu'lie	书名于策，就位朝班。意谓做官。
策名委质	ce'ming'wei'zhi	《左传·僖公二十三年》：“策名委质，贰乃辟也。”杜预注：“名书於所臣之策。”孔颖达疏：“古之仕者於所臣之人书己名於策，以明系属之也。”后用以指因仕宦而献身于朝廷之事。
策驽砺钝	ce'nu'li'dun	驱策劣马，磨砺钝刀。谓勉为其难，努力从事。驽，低能的马；钝，不锋利的刀。
策顽磨钝	ce'wan'mo'dun	鞭策愚顽，磨砺迟钝。极言勉力奋进。
策无遗算	ce'wu'yi'suan	所出谋略周密准确，没有遗漏失算之处。
层出不穷	ceng'chu'bu'qiong	接连不断地出现，没有穷尽。
层出叠见	ceng'chu'die'jian	同“层见叠出”。
层见错出	ceng'jian'cuo'chu	犹层见叠出。
层见迭出	ceng'jian'die'chu	见“层见叠出”。
层见叠出	ceng'jian'die'chu	亦作“层见迭出”。接连不断地多次出现。
层峦叠嶂	ceng'luan'die'zhang	山峰重叠。
插翅难飞	cha'chi'nan'fei	插上翅膀也飞不了。比喻难以逃脱。
插翅难逃	cha'chi'nan'tao	同“插翅难飞”。
插科打诨	cha'ke'da'hun	①以滑稽的动作和诙谐的语言引人发笑。②泛指表演滑稽，开玩笑。
插科使砌	cha'ke'shi'qi	又作：插科打诨。
查无实据	cha'wu'shi'ju	经过调查或审查，没有确实的根据或证据。常同“事出有因”连用。
茶馀饭后	cha'yu'fan'hou	见“茶馀酒后”。
茶馀酒后	cha'yu'jiu'hou	指休息空闲的时刻。
搽脂抹粉	cha'zhi'mo'fen	涂脂抹粉。
察察为明	cha'cha'wei'ming	《晋书·皇甫谧传》：“若乃圣帝之创化也，参德乎二皇，齐风乎虞夏，欲温温而和暢，不欲察察而明切也。”《旧唐书·文苑传上·张蕴古》：“勿浑浑而浊，勿皎皎而清，勿没没而闇，勿察察而明。”后以“察察为明”谓在细枝末节上用心，而自以为明察。
察言观色	cha'yan'guan'se	观察言语脸色，以揣度对方的心意。语出《论语·颜渊》：“夫达也者，质直而好义，察言而观色，虑以下人。”
察言观行	cha'yan'guan'xing	谓考察其言行以知人。
察颜观色	cha'yan'guan'se	观察别人的脸色，以揣摩其心意。
姹紫嫣红	cha'zi'yan'hong	指各种色彩艳丽的花。
差彊人意	cha'qiang'ren'yi	亦作“差强人意”。《后汉书·吴汉传》：“诸将见战陈不利，或多惶惧，失其常度，汉意气自若，方整厉器械，激扬士吏。帝时遣人观大司马何为，还言方修战攻之具，乃叹曰：‘吴公差彊人意，隐若一敌国矣。’”意谓还能振奋人们的意志。后谓尚能令人满意。
差强人意	cha'qiang'ren'yi	见“差彊人意”。
差若毫釐，谬以千里	cha'ruo'hao'li'-'miu'yi'qian'li	以千里】	同“差之毫釐，谬以千里”。
差三错四	cha'san'cuo'si	颠倒错乱。
差之毫氂，失之千里	cha'zhi'hao'mao'-'shi'zhi'qian'li	之千里】	同“差之毫釐，谬以千里”。氂，亦作“釐”。
差之毫釐，谬以千里	cha'zhi'hao'li'-'miu'yi'qian'li	以千里】	开始相差一小点，结果就会造成很大的错误。谬，也写作“缪”。语本《汉书·司马迁传》：“故《易》曰：‘差以豪氂，谬以千里。’”
差之毫釐，失之千里	cha'zhi'hao'li'-'shi'zhi'qian'li	之千里】	见“差之毫氂，失之千里”。
拆东补西	chai'dong'bu'xi	拆掉这里去补那里。比喻临时勉强应付。
拆东墙补西墙	chai'dong'qiang'bu'xi'qiang	】	同“拆东补西”。
钗横鬓乱	chai'heng'bin'luan	形容妇女首饰不整，鬓发散乱。
钗荆裙布	chai'jing'qun'bu	以荆代钗，以布作裙。比喻贫困。语出《太平御览》卷七一八引汉刘向《列女传》：“梁鸿妻孟光，荆钗布裙。”
柴毁骨立	chai'hui'gu'li	谓居亲丧哀伤过甚，骨瘦如柴。
柴立不阿	chai'li'bu'a	又作：刚直不阿。
柴米夫妻	chai'mi'fu'qi	系于生计需要而结合的夫妻。
柴天改物	chai'tian'gai'wu	谓改朝换代。改物，改变前朝的文物制度。
柴天改玉	chai'tian'gai'yu	谓改朝换代。柴天，烧柴祭天；改玉，改换佩玉。
豺狼当道	chai'lang'dang'dao	亦作“豺狼横道”。亦作“豺狼当路”。比喻暴虐奸邪的人掌握国政。
豺狼当路	chai'lang'dang'lu	见“豺狼当道”。
豺狼横道	chai'lang'heng'dao	见“豺狼当道”。
攙前落后	chan'qian'luo'hou	抢前落后，不整肃。
攙行夺市	chan'xing'duo'shi	跨行业抢生意。比喻越权夺职。
谗口铄金	chan'kou'shuo'jin	极言谗言毁贤害能之厉害。谓足使金石为之熔化。
禅世雕龙	chan'shi'diao'long	《后汉书·崔骃传赞》：“崔为文宗，世禅雕龙。”后因以“禅世雕龙”谓文章世代相传。
禅絮沾泥	chan'xu'zhan'ni	比喻禅寂之心受到尘世烦恼的沾染。
馋涎欲滴	chan'xian'yu'di	①因十分想吃而口水将要滴落。②比喻欲望十分强烈。
缠绵悱恻	chan'mian'fei'ce	见“缠绵悱恻”。
缠绵悱恻	chan'mian'fei'ce	形容文词、音乐之哀婉动人；形容人物之情深意厚、悲苦凄切。
缠绵缱绻	chan'mian'qian'quan	见“缠绵缱绻”。
缠绵缱绻	chan'mian'qian'quan	形容情意深厚，难舍难分。
蝉喘雷乾	chan'chuan'lei'qian	蝉喘息，无雷声。形容酷热干旱。
蝉腹@肠	chan'fu'@'chang	蝉饮露而腹空，龟耐饥而肠细。比喻穷困的处境。
蝉联蚕绪	chan'lian'can'xu	比喻连续相承。
蝉联往复	chan'lian'wang'fu	不断重演。
蝉緌蟹匡	chan'rui'xie'kuang	《礼记·檀弓下》：“成人有其兄死而不为衰（缞）者，闻子皋将为成宰，遂为衰。成人曰：‘蚕则绩而蟹有匡，范则冠而蝉有緌，兄则死而子皋为之衰。’”后以“蝉緌蟹匡”比喻事物间互相矛盾。
蝉衫麟带	chan'shan'lin'dai	薄绢制的衣衫，有文采的衣带。指飘逸华美的服装。
蝉蜕龙变	chan'tui'long'bian	又作：蝉蜕蛇解。
蝉蜕蛇解	chan'tui'she'jie	①如蝉脱壳，如龙蛇换皮。比喻解脱而进入更高境界。②后世道教多以指羽化成仙。
蝉翼为重，千钧为轻	chan'yi'wei'zhong'-'qian'jun'wei'qing	钧为轻】	轻重倒置。比喻是非混淆，善恶不明。
蟾宫扳桂	chan'gong'ban'gui	见“蟾宫折桂”。
蟾宫折桂	chan'gong'zhe'gui	《晋书·郤诜传》：“武帝於东堂会送，问诜曰：‘卿自以为何如？’诜对曰：‘臣举贤良对策，为天下第一，犹桂林之一枝。昆山之片玉。’”相传蟾宫中有桂树，唐以来牵合两事，遂以“蟾宫折桂”谓科举应试及第。
剗草除根	chan'cao'chu'gen	犹斩草除根。语本《左传·隐公六年》：“为国家者，见恶，如农夫之务去草焉，芟夷蕰崇之，绝其本根，勿使能殖。”
剗恶锄奸	chan'e'chu'jian	铲除凶恶奸邪之人。
剗旧谋新	chan'jiu'mou'xin	犹除旧图新。
谄笑胁肩	chan'xiao'xie'jian	讨好地强装笑脸，缩敛肩膀。形容阿谀逢迎的丑态。
阐扬光大	chan'yang'guang'da	发扬光大。谓使美好的事物在原来基础上不断发展、扩大和提高。
阐幽抉微	chan'you'jue'wei	阐明幽隐，抉发精微。
阐幽明微	chan'you'ming'wei	使幽深隐微的事物或道理显露出来。
阐幽探奥	chan'you'tan'ao	阐明和探讨深奥精微的道理。
昌歜羊枣	chang'chu'yang'zao	据传周文王嗜昌歜，春秋鲁曾点嗜羊枣。后以“昌歜羊枣”指人所偏好之物。
昌亭旅食	chang'ting'lv'shi	谓寄食南昌亭长处。借指寄人篱下。
昌亭之客	chang'ting'zhi'ke	下乡（属江苏省淮阴市）南昌亭长的食客。原指汉淮阴侯韩信。《汉书·韩信传》：“韩信，淮阴人。家贫无行，不得推择为吏……从下乡南昌亭长食。”后以借指怀才未遇而暂寄人篱下者。
长安棋局	chang'an'qi'ju	唐杜甫《秋兴》诗之四：“闻道长安似弈棋，百年世事不胜悲。”后以“长安棋局”喻动荡不定的政局。
长安少年	chang'an'shao'nian	旧指都城里豪奢轻狂的贵家子弟。
长傲饰非	chang'ao'shi'fei	滋长骄傲、掩饰过错。
长才短驭	chang'cai'duan'yu	又作：大才小用。
长才广度	chang'cai'guang'du	指才能出众器量宏大的人。
长材茂学	chang'cai'mao'xue	指才能高学问大的人。
长材小试	chang'cai'xiao'shi	又作：大材小用。
长春不老	chang'chun'bu'lao	又作：长生不老。
长此以往	chang'ci'yi'wang	长久地这样下去。
长恶不悛	chang'e'bu'quan	长期作恶，不肯悔改。
长恶靡悛	chang'e'mi'quan	见“长恶不悛”。
长风破浪	chang'feng'po'lang	《宋书·宗悫传》：“悫年少时，炳（悫叔父）问其志，悫曰：‘原乘长风破万里浪。’”后比喻人的志向远大，气魄雄伟，奋勇前进。
长歌当哭	chang'ge'dang'ku	以歌代哭。多指用诗文来倾吐悲愤之情。
长虺成蛇	chang'hui'cheng'she	喻养奸遗患。
长戟高门	chang'ji'gao'men	门庭高大，门内列戟。形容旧时显贵人家的威仪。
长计远虑	chang'ji'yuan'lv	长远打算。
长驾远驭	chang'jia'yuan'yu	喻帝王用某种政策、手段羁縻边远地区。
长街短巷	chang'jie'duan'xiang	又作：大街小巷。
长颈鸟喙	chang'jing'niao'hui	长颈尖嘴。喻人奸诈阴险。
长林丰草	chang'lin'feng'cao	①三国魏嵇康《与山巨源绝交书》：“此由禽鹿少见驯育，则服从教制，长而见羁,，则狂顾顿缨，赴蹈汤火，虽饰以金镳，飨以嘉肴，逾思长林而志在丰草也。”本谓高大的树林、丰茂的野草，为禽兽栖止之佳处。后用以指隐逸者所居。②指隐逸。
长虑顾后	chang'lv'gu'hou	顾及未来而作长远打算。
长虑后顾	chang'lv'hou'gu	见“长虑顾后”。
长虑卻顾	chang'lv'que'gu	同“长虑顾后”。
长鸣都尉	chang'ming'du'wei	鸡的别名。
长命百岁	chang'ming'bai'sui	谓寿命长，活到百岁。
长命富贵	chang'ming'fu'gui	语出《旧唐书·姚崇传》：“经（佛经）云：‘求长命得长命，求富贵得富贵。’”后用作祝颂语，指既长寿又富裕显贵。
长目飞耳	chang'mu'fei'er	《管子·九守》：“一曰长目，二曰飞耳，三曰树明，明知千里之外，隐微之中。”后用以指扩大视听的手段。
长年累月	chang'nian'lei'yue	谓很长时期。长年，整年；累月，月复一月。
长念卻虑	chang'nian'que'lv	思前顾后，反覆考虑。卻，后。
长辔远驭	chang'pei'yuan'yu	见“长辔远御”。
长辔远御	chang'pei'yuan'yu	①放长缰绳，驾马远行。比喻帝王用某种政策、手段羁縻边远地区。②比喻驾驭创作手段从容达到写作的理想境界。
长篇大论	chang'pian'da'lun	见“长篇大套”。
长篇大套	chang'pian'da'tao	大段的议论、言论或长篇的文章。
长篇累牍	chang'pian'lei'du	指文章篇幅很长。
长驱深入	chang'qu'shen'ru	又作：长驱直入。
长驱直进	chang'qu'zhi'jin	又作：长驱直入。
长驱直入	chang'qu'zhi'ru	不停顿地向远方目标快速前进。多形容进军顺利。
长蛇封豕	chang'she'feng'shi	长蛇和大猪。比喻贪暴者。
长生不老	chang'sheng'bu'lao	长久生存，永不衰老。
长生不死	chang'sheng'bu'si	长久生存，永不死亡。
长生久视	chang'sheng'jiu'shi	长久地活着。
长绳系景	chang'sheng'xi'jing	见“长绳系日”。
长绳系日	chang'sheng'xi'ri	谓留住时光。语本晋傅玄《九曲歌》：“岁莫景迈群光绝，安得长绳系白日！”
长算远略	chang'suan'yuan'lve	又作：深谋远虑。
长谈阔论	chang'tan'kuo'lun	高谈阔论。
长往远引	chang'wang'yuan'yin	谓引身远行，一去不返。
长袖善舞	chang'xiu'shan'wu	喻有所凭借，事情容易成功。《韩非子·五蠹》：“鄙谚曰：‘长袖善舞，多钱善贾。’此言多资之易为工也。”郑观应《盛世危言·银行上》：“泰西各国多设银行，以维持商务，长袖善舞，为百业之总枢。”后多用来形容有财势有手腕的人善于钻营。
长嘘短叹	chang'xu'duan'tan	见“长吁短叹”。
长吁短气	chang'xu'duan'qi	见“长吁短叹”。
长吁短叹	chang'xu'duan'tan	谓叹息不已。
长枕大被	chang'zhen'da'bei	语出《北堂书钞》卷一三四引汉蔡邕《协初赋》：“长枕横施，大被竟床。”谓共倚长枕，同拥大被，形容夫妇相爱。后用以喻兄弟友爱。
长枕大衾	chang'zhen'da'qin	见“长枕大被”。
长治久安	chang'zhi'jiu'an	长期治平，永久安定。语出《汉书·贾谊传》：“建久安之势，成长治之业。”
肠肥脑满	chang'fei'nao'man	形容不劳而食，养尊处优，无所用心。
尝胆眠薪	chang'dan'mian'xin	见“尝胆卧薪”。
尝胆卧薪	chang'dan'wo'xin	春秋时，越王勾践自吴释归后，以柴草为床褥，经常尝苦胆，立志灭吴，报仇雪耻。事见《史记·越王勾践世家》。后因以“尝胆卧薪”比喻刻苦自励，发愤图强。
尝鼎一脔	chang'ding'yi'luan	语本《吕氏春秋·察今》：“尝一脟肉而知一镬之味、一鼎之调”。尝尝鼎里一片肉的味道，可以知道整个鼎里的肉味。比喻根据部分可推知全体。
常备不懈	chang'bei'bu'xie	经常准备着，毫不松懈。
常年累月	chang'nian'lei'yue	长年累月。形容经过的时间很长。
倡情冶思	chang'qing'ye'si	冶荡轻佻的情思。
倡条冶叶	chang'tiao'ye'ye	①指杨柳婀娜多姿的枝叶。后亦泛称美丽多姿的花草树木。②借喻歌伎、妓女。
唱筹量沙	chang'chou'liang'sha	《南史·檀道济传》：“道济时与魏军三十馀战多捷，军至历城，以资运竭乃还。时人降魏者具说粮食已罄，於是士卒忧惧，莫有固志。道济夜唱筹量沙，以所馀少米散其上。及旦魏军谓资粮有馀，故不复追。”后以“唱筹量沙”为安定军心，迷惑敌人之典。
唱沙作米	chang'sha'zuo'mi	比喻以假乱真或以劣为优。
暢叫扬疾	chang'jiao'yang'ji	谓大吵大闹。“暢叫”即“唱叫”，吵闹之意。“扬疾”犹嚷唧，亦吵闹之意。
暢所欲为	chang'suo'yu'wei	痛痛快快地做想做的事。
暢所欲言	chang'suo'yu'yan	痛痛快快地说出想说的话。
超超玄箸	chao'chao'xuan'zhu	谓言辞高妙，不同凡俗。
超尘拔俗	chao'chen'ba'su	谓不同于一般世俗之见。
超尘逐电	chao'chen'zhu'dian	腾空而行，追逐电光。形容奔驰之速。
超凡入圣	chao'fan'ru'sheng	①谓脱离凡尘，修道成仙。②谓达到登峰造极、超越凡庸的境界。
超古冠今	chao'gu'guan'jin	见“超今冠古”。
超今冠古	chao'jin'guan'gu	谓古今第一，无与伦比。
超今绝古	chao'jin'jue'gu	同“超今冠古”。
超类绝伦	chao'lei'jue'lun	谓超出寻常，无与伦比。
超伦轶群	chao'lun'yi'qun	又作：超群出众。
超前绝后	chao'qian'jue'hou	又作：空前绝后。
超前轶后	chao'qian'yi'hou	又作：空前绝后。
超群拔萃	chao'qun'ba'cui	又作：出类拔萃。形容超越寻常；杰出。
超群拔类	chao'qun'ba'lei	见“超群拔类”。
超群拔类	chao'qun'ba'lei	同“超群拔萃”。
超群出众	chao'qun'chu'zhong	见“超群出众”。
超群出众	chao'qun'chu'zhong	胜过众人。
超群绝伦	chao'qun'jue'lun	见“超类绝伦”。
超然物外	chao'ran'wu'wai	①超出于尘世之外。②引申为置身事外的意思。
超然象外	chao'ran'xiang'wai	又作：超然物外。
超世绝伦	chao'shi'jue'lun	谓杰出不凡，胜过一般。
超世绝俗	chao'shi'jue'su	超出于世俗之外。
超轶绝尘	chao'yi'jue'chen	①谓骏马奔驰，出群超众，不着尘埃。②比喻出类拔萃，不同凡俗。
超逸绝尘	chao'yi'jue'chen	同“超轶绝尘”。
巢焚原燎	chao'fen'yuan'liao	极言战祸惨烈。
巢林一枝	chao'lin'yi'zhi	语本《庄子·逍遥游》：“鹪鷯巢於深林，不过一枝。”谓鹪鹩筑巢，只不过占用一根树枝。后以“巢林一枝”比喻安本分，不贪多。
巢倾卵覆	chao'qing'luan'fu	见“巢倾卵破”。
巢倾卵破	chao'qing'luan'po	《后汉书·孔融传》载：孔融被曹操逮捕时，有女七岁，子九岁，两人正在下棋，安坐不动。左右问父被捕为何不起，答曰：“安有巢毁而卵不破乎！”意谓父被害，自己也不得幸免。后因以“巢倾卵破”比喻灭门之祸，无一得免。亦以喻整体被毁，其中的个别也不可能幸存。
朝不保暮	zhao'bu'bao'mu	早晨保不住晚上会发生变化。极言情况危急或境遇窘迫。
朝不保夕	zhao'bu'bao'xi	见“朝不保暮”。
朝不及夕	zhao'bu'ji'xi	①谓早晨不能顾及晚上。极言处境危急。②形容生活极其穷困。
朝不虑夕	zhao'bu'lv'xi	见“朝不谋夕”。
朝不谋夕	zhao'bu'mou'xi	谓早晨不能预为晚上打算。形容形势危急或境况窘迫。
朝趁暮食	zhao'chen'mu'shi	白天挣了钱，晚上才有饭吃。形容生活十分贫困。
朝成暮徧	zhao'cheng'mu'bian	早晨刚写成，晚上就到处流传。形容文章流传迅速。
朝成暮毁	zhao'cheng'mu'hui	形容翻新之速。
朝成夕毁	zhao'cheng'xi'hui	见“朝成暮毁”。
朝发暮至	zhao'fa'mu'zhi	谓早晨出发晚上就到达。形容路程很近或交通方便。语出《后汉书·乌桓传》：“居止近塞，朝发穹庐，暮至城郭，五郡民庶，家受其辜。”
朝发夕至	zhao'fa'xi'zhi	见“朝发暮至”。
朝歌暮弦	zhao'ge'mu'xian	见“朝歌夜弦”。
朝歌夜弦	zhao'ge'ye'xian	形容整天沉迷于歌舞，逸乐无度。
朝过夕改	zhao'guo'xi'gai	早晨闻过，晚上即改正。形容改正错误之迅速。
朝欢暮乐	zhao'huan'mu'le	谓终日欢乐；日夜寻欢作乐。
朝懽暮乐	zhao'huan'mu'le	见“朝欢暮乐”。
朝齑暮盐	zhao'ji'mu'yan	见“朝齑暮盐”。
朝齑暮盐	zhao'ji'mu'yan	早饭腌菜进食，晚餐蘸盐下饭。极言生活贫苦。
朝梁暮陈	zhao'liang'mu'chen	见“朝梁暮晋”。
朝梁暮晋	zhao'liang'mu'jin	五代冯道为相，历五朝八姓，于丧君亡国略不在意。自号长乐老，著《长乐老自叙》，历陈官爵以为荣，时论卑之。元刘因有《冯道》诗讽之曰：“亡国降臣固位难，痴顽老子几朝官。朝梁暮晋浑閒事，更舍残骸与契丹。”后因以“朝梁暮晋”喻人反复无常，没有节操。
朝梁暮周	zhao'liang'mu'zhou	见“朝梁暮晋”。
朝令暮改	zhao'ling'mu'gai	《汉书·食货志上》：“急政暴赋，赋敛不时，朝令而暮改。”王念孙《读书杂志·汉书四》：“‘朝令而暮改’，改，本作得，言急征暴赋，朝出令而暮已得。非谓其朝令而暮改也。”后以“朝令暮改”形容政令多变。
朝令夕改	zhao'ling'xi'gai	早晨下命令，晚上就改变。形容政令多变。
朝攀暮折	zhao'pan'mu'zhe	谓不断地攀折。比喻时时遭摧残。
朝乾夕愓	zhao'qian'xi'dang	谓终日勤奋谨慎，不敢懈怠。语本《易·乾》：“君子终日乾乾，夕惕若厉，无咎。”
朝秦暮楚	zhao'qin'mu'chu	①战国时，秦楚两大国对立，其他小国各视利益之所在，时而事秦，时而奉楚，变化无常。游说之士亦如此。后以喻人反复无常。②朝在秦地，暮在楚地。或朝属秦国，暮属楚国。比喻行踪无定或生活不安定。
朝三暮二	zhao'san'mu'er	比喻主意多变。
朝三暮四	zhao'san'mu'si	①《庄子·齐物论》：“狙公赋芧，曰：‘朝三而暮四。’众狙皆怒。曰：‘然则朝四而暮三。’众狙皆悦。”本谓只变名目，不变实质以欺人。后以喻变化多端或反覆无常。②形容数目多。
朝升暮合	zhao'sheng'mu'he	谓零碎地籴米。形容生活艰难，勉强度日。
朝生暮死	zhao'sheng'mu'si	亦作“朝生夕死”。①早晨刚生，晚上就死亡。②今亦形容事物生命短暂。
朝生夕死	zhao'sheng'xi'si	见“朝生暮死”。
朝思暮想	zhao'si'mu'xiang	日夜思念。
朝闻夕改	zhao'wen'xi'gai	见“朝过夕改”。
朝闻夕死	zhao'wen'xi'si	早晨闻道，晚上可死去。形容对真理或某种信仰追求的迫切。语本《论语·里仁》：“朝闻道，夕死可矣。”
朝夕相处	zhao'xi'xiang'chu	彼此天天在一起。
朝阳鸣凤	zhao'yang'ming'feng	比喻品德出众、正直敢谏之人。语出《诗·大雅·卷阿》：“凤凰鸣矣，于彼高冈，梧桐生矣，于彼朝阳。”
朝衣东市	zhao'yi'dong'shi	谓大臣就戮。典出《史记·袁盎晁错列传》：“上令晁错衣朝衣斩东市。”
朝夷暮跖	zhao'yi'mu'zhi	早晨被誉为伯夷，晚上被贬作盗跖。形容时论毁誉多变。
朝饔夕飧	zhao'yong'xi'sun	谓才疏力薄，除吃饭外别无所能。
朝云暮雨	zhao'yun'mu'yu	比喻男女欢会。典出战国楚宋玉《〈高唐赋〉序》：楚襄王与宋玉游云梦之台，望高唐之观。其上有云气变化无穷。玉谓此气为朝云，并对王说，过去先王曾游高唐，怠而昼寝，梦见一妇人，自称是巫山之女，愿侍王枕席，王因幸之。巫山之女临去时说：“妾在巫山之阳，高丘之阻，旦为朝云，暮为行雨，朝朝暮暮，阳台之下。”
朝章国典	zhao'zhang'guo'dian	见“朝章国故”。
朝章国故	zhao'zhang'guo'gu	朝廷与国家的典章制度。
朝折暮折	zhao'zhe'mu'zhe	见“朝攀暮折”。
朝钟暮鼓	zhao'zhong'mu'gu	亦作“朝锺暮鼓”。佛寺晨撞钟，暮击鼓以报时。
朝钟暮鼓	zhao'zhong'mu'gu	见“朝钟暮鼓”。
朝锺暮鼓	zhao'zhong'mu'gu	见“朝钟暮鼓”。
朝种暮穫	zhao'zhong'mu'huo	①比喻收益迅速。②比喻时间短促。
朝奏暮召	zhao'zou'mu'zhao	谓早晨上书帝王，晚上就被召见。形容被朝廷任用之速。语出《史记·平津侯主父列传》：“扞主父偃呴资用乏，留久，诸公宾客多厌之，乃上书阙下。朝奏，暮召入见。所言九事，其八事为律令，一事谏伐匈奴。”
朝奏夕召	zhao'zou'xi'zhao	见“朝奏暮召”。
鼌不及夕	chao'bu'ji'xi	早晨不能顾及晚上。形容处境危急。出处《汉书·严助传》:“边境之民为之早闭晏开,鼌不及夕。”颜师古注:“鼌,古朝字也。言忧危亡不自保也。”
嘲风弄月	chao'feng'nong'yue	吟咏清风，玩赏月色。泛指写诗抒情。
嘲风咏月	chao'feng'yong'yue	①唐白居易《与元九书》：“至于梁陈间，率不过嘲风雪弄花草而已。”后因以“嘲风咏月”指描写风云月露等景物而思想内容贫乏的作品。②泛指吟诗作赋。
潮鸣电掣	chao'ming'dian'che	极言气势大、速度炔。
炒买炒卖	chao'mai'chao'mai	指就地迅速转手买卖，从中牟利。
车尘马足	che'chen'ma'zu	①谓车马奔波。亦喻人世俗事。②指代车骑。敬称对方时亦用之。
车驰马骤	che'chi'ma'zhou	形容车马奔驰迅猛。
车怠马烦	che'dai'ma'fan	见“车殆马烦”。
车殆马烦	che'dai'ma'fan	车危且马疲。形容旅途困乏。
车烦马毙	che'fan'ma'bi	形容旅途劳顿困乏。
车轨共文	che'gui'gong'wen	车同轨，书同文。指统一。
车击舟连	che'ji'zhou'lian	车相撞，船相连。极言车船之多。
车量斗数	che'liang'dou'shu	形容巨量。
车马如龙	che'ma'ru'long	谓车马众多，繁华热闹。
车马填门	che'ma'tian'men	见“车马盈门”。
车马盈门	che'ma'ying'men	车马充满门庭。形容宾客众多。
车水马龙	che'shui'ma'long	《后汉书·皇后纪上·明德马皇后》“前过濯龙门上，见外家问起居者，车如流水，马如游龙。”后以“车水马龙”形容车马往来不绝，繁华热闹的景象。
车填马隘	che'tian'ma'ai	谓车马填塞门庭道路。形容宾客众多。
车载船装	che'zai'chuan'zhuang	形容数量很多。
车载斗量	che'zai'dou'liang	形容数量很多。多用以表示不足为奇。
车辙马迹	che'zhe'ma'ji	见“车辙马迹”。
车辙马迹	che'zhe'ma'ji	车马行过的痕迹。
扯篷拉纤	che'peng'la'xian	比喻从事不正当的介绍撮合以从中取利。
扯旗放砲	che'qi'fang'pao	比喻公开张扬。
扯顺风旗	che'shun'feng'qi	比喻顺势迎合，奉承别人。
扯纤拉烟	che'xian'la'yan	犹扯篷拉纤。
撦鼓夺旗	che'gu'duo'qi	形容作战勇敢。
彻里彻外	che'li'che'wai	①从里到外。②又作：完完全全。
彻里至外	che'li'zhi'wai	见“彻里彻外”。
彻内彻外	che'nei'che'wai	见“彻里彻外”。
彻上彻下	che'shang'che'xia	贯通上下；通达上下。
彻头彻尾	che'tou'che'wei	①从头到尾；自始至终。②又作：完完全全。
澈底澄清	che'di'cheng'qing	谓完全清楚，毫无遗漏。
瞋目扼腕	chen'mu'e'wan	形容愤怒、勇敢的样子。
瞋目搤腕	chen'mu'e'wan	见“瞋目扼腕”。
瞋目扌戹掔	chen'mu'shou'e'qian		见“瞋目扼腕”。
瞋目竖眉	chen'mu'shu'mei	瞪大眼睛，竖直眉毛。形容非常恼怒的样子。
瞋目张胆	chen'mu'zhang'dan	形容有胆有识，敢作敢为。
尘饭涂羹	chen'fan'tu'geng	以土作饭，以泥作羹。比喻以假当真或无足轻重的事物。
尘羹涂饭	chen'geng'tu'fan	见“尘饭涂羹”。
尘垢粃糠	chen'gou'bi'kang	灰尘和污垢，谷粃和米糠。喻卑微无用之物。
臣门如市	chen'men'ru'shi	语出《汉书·郑崇传》。喻车马盈门，谒见奔走者甚多。
臣心如水	chen'xin'ru'shui	①谓为臣者廉洁奉公，心清如水。②用为清静自如之喻。
陈陈相因	chen'chen'xiang'yin	①谓陈谷逐年增积。②比喻因袭陈旧，缺乏创新。
陈词滥调	chen'ci'lan'diao	亦作“陈辞滥调”。陈旧、空泛的言词。
陈辞滥调	chen'ci'lan'diao	见“陈词滥调”。
陈古刺今	chen'gu'ci'jin	借古讽今。
陈力就列	chen'li'jiu'lie	指在所任职位上能恪尽职守。
陈言肤词	chen'yan'fu'ci	陈旧而肤浅的言词。
陈言老套	chen'yan'lao'tao	陈旧的言词和套数。
晨参暮礼	chen'can'mu'li	早晚参拜。
晨参暮省	chen'can'mu'sheng	按礼节朝暮参拜问安。
晨昏定省	chen'hun'ding'sheng	同“昏定晨省”。旧时指朝夕服侍慰问双亲。
晨兢夕厉	chen'jing'xi'li	谓终日勤勉谨慎。
晨秦暮楚	chen'qin'mu'chu	又作：朝秦暮楚。比喻反复无常。
晨提夕命	chen'ti'xi'ming	又作：朝夕教诲。
晨钟暮鼓	chen'zhong'mu'gu	①语本唐李咸用《山中》诗：“朝钟暮鼓不到耳，明月孤云长挂情”。佛寺中晨撞钟暮击鼓以报时，后因以“晨钟暮鼓”谓时日推移。②比喻令人警悟的话。
闯南走北	chuang'nan'zou'bei	奔走四方。
疢如疾首	chen'ru'ji'shou	烦热得如患有头痛之疾。比喻忧伤到极点。
称柴而爨	cheng'chai'er'cuan	见“称薪而爨”。
称帝称王	cheng'di'cheng'wang	见“称王称霸”。
称功诵德	cheng'gong'song'de	见“称功颂德”。
称功颂德	cheng'gong'song'de	称颂功德。
称孤道寡	cheng'gu'dao'gua	谓以帝王自居。
称斤掂两	cheng'jin'dian'liang	计算重量。谓计较多少、轻重。
称斤约两	cheng'jin'yue'liang	比喻权衡得失。
称名道姓	cheng'ming'dao'xing	称呼姓名。
称奇道绝	cheng'qi'dao'jue	觉得奇怪难得。
称觞举寿	cheng'shang'ju'shou	同“称觞上寿”。
称觞上寿	cheng'shang'shang'shou	举杯饮酒，表示祝寿。
称王称霸	cheng'wang'cheng'ba	谓自封为帝王或以首领自居。亦以喻狂妄自大，专横独断。原作“称帝称王”。三国魏曹操《让县自明本志令》：“设使国家无有孤，不知当几人称帝，几人称王。”宋刘克庄《魏志》诗：“称帝称王非一个，国家不可便无孤。此言只是瞒孀幼，岂有英雄也恁愚？”后多作“称王称霸”。
称王称伯	cheng'wang'cheng'bo	见“称王称霸”。
称物平施	cheng'wu'ping'shi	根据物品的多少，做到施与均衡。
称贤使能	cheng'xian'shi'neng	举用贤能之人。
称心快意	cheng'xin'kuai'yi	满足心意。
称心满意	cheng'xin'man'yi	又作：称心如意。
称心满意	cheng'xin'man'yi	心满意足。
称心满原	cheng'xin'man'yuan	又作：称心如意。
称心如意	cheng'xin'ru'yi	完全合乎心意。
称薪而爨	cheng'xin'er'cuan	称了薪柴才去生火煮饭。比喻斤斤于细节而不识大体。
称兄道弟	cheng'xiong'dao'di	指朋友间以兄弟相称呼。表示关系亲密。
趁波逐浪	chen'bo'zhu'lang	形容奔波；颠沛。
趁风使柁	chen'feng'shi'tuo	比喻随机应变或迎合别人行事。
趁风转帆	chen'feng'zhuan'fan	比喻根据情势的变化而转向，见机行事。
趁风转篷	chen'feng'zhuan'peng	见“趁风转帆”。
趁哄打劫	chen'hong'da'jie	又作：在混乱中劫掠。
趁火打劫	chen'huo'da'jie	趁人家失火的时候去抢劫。比喻趁别人紧张危急的时候去捞取好处或趁机害人。
趁火抢劫	chen'huo'qiang'jie	同“趁火打劫”。
趁夥打劫	chen'huo'da'jie	又作：趁火打劫。
趁浪逐波	chen'lang'zhu'bo	谓随波逐流，从俗浮沉。
趁热打铁	chen're'da'tie	比喻做事抓住有利时机或条件，加速进行。
趁人之危	chen'ren'zhi'wei	趁着别人有困难的时候，加以要挟或陷害。
趁水和泥	chen'shui'he'ni	利用现成的水来搅泥。比喻乘机行事。
趁心如意	chen'xin'ru'yi	称心如意。谓符合心意，满足愿望。趁，通“称”。
撑岸就船	cheng'an'jiu'chuan	比喻颠倒主从，不合情理。
撑肠拄肚	cheng'chang'zhu'du	腹中饱满。比喻容受很多。
撑肠拄腹	cheng'chang'zhu'fu	犹撑肠拄肚。
撑天拄地	cheng'tian'zhu'di	又作：顶天立地。
撑霆裂月	cheng'ting'lie'yue	形容声气惊人。
瞠乎后已	cheng'hu'hou'yi	见“瞠乎后矣”。
瞠乎后矣	cheng'hu'hou'yi	又作：瞠乎其后。
瞠乎其后	cheng'hu'qi'hou	干瞪着眼，落在后面趕不上。语出《庄子·田子方》：“夫子奔逸绝尘，而回瞠若乎后矣！”
瞠目挢舌	cheng'mu'jiao'she	见“瞠目结舌”。
瞠目结舌	cheng'mu'jie'she	瞪着眼睛说不出话来。形容窘迫或惊呆的样子。
瞠目咋舌	cheng'mu'zha'she	见“瞠目结舌”。
瞠然自失	cheng'ran'zi'shi	瞪着眼就像失落什么似的。
成败得失	cheng'bai'de'shi	犹成败利钝。
成败利钝	cheng'bai'li'dun	成功或失败，顺利或挫折。谓事情的结果好坏。
成败论人	cheng'bai'lun'ren	以成功或失败作为评论人物的标准。
成败兴废	cheng'bai'xing'fei	成功或失败，兴起或衰退。
成帮结队	cheng'bang'jie'dui	犹成群结队。
成城断金	cheng'cheng'duan'jin	谓万众一心，力量无比强大。
成风尽垩	cheng'feng'jin'e	同“成风斤”。
成风之斫	cheng'feng'zhi'zhuo	同“成风斤”。
成佛作祖	cheng'fo'zuo'zu	佛教语。谓修成佛道，成为祖师。亦以喻获得杰出成就。
成己成物	cheng'ji'cheng'wu	谓由己及物，自身有所成就，也要使自身以外的一切有所成就。语本《礼记·中庸》：“诚者，非自成己而已也，所以成物也。成己，仁也；成物，知也。性之德也，合内外之道也。”孔颖达疏：“言人有至诚，非但自成就己身而已，又能成就外物。”
成家立计	cheng'jia'li'ji	又作：成家立业。
成家立业	cheng'jia'li'ye	成立家庭，建立家业。
成名成家	cheng'ming'cheng'jia	树立名声，成为专家。
成年古代	cheng'nian'gu'dai	又作：长期以来。
成年累月	cheng'nian'lei'yue	极言时间之长。
成千成万	cheng'qian'cheng'wan	极言数量之多。
成千累万	cheng'qian'lei'wan	见“成千成万”。
成千论万	cheng'qian'lun'wan	又作：成千成万。形容数量极多。
成千上万	cheng'qian'shang'wan	见“成千成万”。
成群打夥	cheng'qun'da'huo	见“成群结夥”。
成群集党	cheng'qun'ji'dang	谓一部分人结成小团体。
成群结党	cheng'qun'jie'dang	见“成群集党”。
成群结队	cheng'qun'jie'dui	众多的人或动物结成一群群、一队队。
成群结夥	cheng'qun'jie'huo	犹成群结队。谓众多的人或动物聚结成一群群、一伙伙。
成群逐队	cheng'qun'zhu'dui	见“成群结队”。
成群作队	cheng'qun'zuo'dui	见“成群结队”。
成人不自在，自在不成人	cheng'ren'bu'zi'zai'-'zi'zai'bu'cheng'ren	自在不成人】	人要有所成就，就不能贪图安逸；贪图安逸，就不能有所成就。
成人之美	cheng'ren'zhi'mei	成全他人为善的美名。
成人之善	cheng'ren'zhi'shan	成全别人为善。
成仁取义	cheng'ren'qu'yi	为正义事业而牺牲。
成日成夜	cheng'ri'cheng'ye	整天整夜，日日夜夜。
成事不说	cheng'shi'bu'shuo	对做过的事不再提它。
成事不足，败事有馀	cheng'shi'bu'zu'-'bai'shi'you'yu	事有馀】	不能把事情办好，只能把事情弄坏。
成双成对	cheng'shuang'cheng'dui	见“成双作对”。
成双作对	cheng'shuang'zuo'dui	配成一对。
成团打塊	cheng'tuan'da'kuai	聚集成群。
成王败寇	cheng'wang'bai'kou	见“成则为王，败则为寇”。
成也萧何，败也萧何	cheng'ye'xiao'he'-'bai'ye'xiao'he	也萧何】	宋洪迈《容斋续笔·萧何绐韩信》：“韩信为人告反，吕后欲召，恐其不就，乃与萧相国谋，诈令人称陈豨已破，绐信曰：‘虽病强入贺。’信入，即被诛。信之为大将军，实萧何所荐，今其死也，又出其谋，故俚语有‘成也萧何，败也萧何’之语。”后以“成也萧何，败也萧何”比喻事情的成败都出于同一个人。
成也萧何败萧何	cheng'ye'xiao'he'bai'xiao'he	何】	见“成也萧何，败也萧何”。
成则为王，败则为寇	cheng'ze'wei'wang'-'bai'ze'wei'kou	则为寇】	旧谓在争夺政权斗争中，成功了的就是合法的，称帝称王；失败了的就是非法的，被称为寇贼。反映了以成败论人的观点。
成则为王，败则为虏	cheng'ze'wei'wang'-'bai'ze'wei'lu	则为虏】	见“成则为王，败则为寇”。
成则为王，败则为贼	cheng'ze'wei'wang'-'bai'ze'wei'zei	则为贼】	见“成则为王，败则为寇”。
成竹在胸	cheng'zhu'zai'xiong	画竹子以前，心中先已有竹子的形象。语本宋苏轼《文与可画筼筜谷偃竹记》：“故画竹，必先得成竹於胸中，执笔熟视，乃见其所欲画者，急起从之，振笔直遂，以追其所见，如兔起鹘落，少纵则逝矣。”后以喻处理事情之前心里早有通盘的考虑和打算。
承前启后	cheng'qian'qi'hou	犹承上起下。
承嬗离合	cheng'shan'li'he	继承演变。
承上起下	cheng'shang'qi'xia	承接前者，引出后者。
承先启后	cheng'xian'qi'hou	犹承上起下。
承星履草	cheng'xing'lv'cao	头戴星光，脚踏草地。形容早出晚归辛勤劳作。
诚惶诚恐	cheng'huang'cheng'kong	①封建时代奏章中的套话。表示惶恐不安。②今泛用以形容小心谨慎以至于害怕不安的样子。
诚心诚意	cheng'xin'cheng'yi	亦作“诚心实意”。①真实的心志。②谓心意真诚。
诚心实意	cheng'xin'shi'yi	见“诚心诚意”。
诚至金开	cheng'zhi'jin'kai	精诚所至，金石为开。
城狐社鼠	cheng'hu'she'shu	城墙洞中的狐狸，社坛里的老鼠。比喻有所凭依而为非作歹的人。语本《晏子春秋·问上九》：“夫社，束木而涂之，鼠因往讬焉，熏之则恐烧其木，灌之则恐败其涂，此鼠所以不可得杀者，以社故也。”
城门失火，殃及池鱼	cheng'men'shi'huo'-'yang'ji'chi'yu	及池鱼】	相传春秋时，宋国池仲鱼所居近城门，一次城门失火，延及其家，仲鱼烧死。一说宋城门失火，因汲水灭火，池水干涸，鱼皆枯死。见《艺文类聚》卷九六及《太平广记》卷四六六引汉应劭《风俗通》。后用以比喻无端受牵连而遭祸害。
城门鱼殃	cheng'men'yu'yang	见“城门失火，殃及池鱼”。
城下之盟	cheng'xia'zhi'meng	①敌人兵临城下时被迫接受的屈辱盟约。②泛指被迫签订的屈辱条约。
城下之辱	cheng'xia'zhi'ru	谓兵临城下屈膝求和的耻辱。
乘车戴笠	cheng'che'dai'li	《初学记》卷十八引晋周处《风土记》：“越俗性率朴，初与人交有礼，封土坛，祭以犬鸡，祝曰：‘卿虽乘车我戴笠，后日相逢下车揖。我步行，卿乘马，后日相逢卿当下。’”乘车，喻富贵；戴笠，喻贫贱。后用以指友谊深厚，不因贫富贵贱而有所改变。
乘肥衣轻	cheng'fei'yi'qing	坐着骏马驾的车子，穿着轻暖的皮袍。比喻豪华的生活。
乘风破浪	cheng'feng'po'lang	①顺着风，破浪前进。②比喻人的志向远大，气魄雄伟，奋勇前进。
乘风兴浪	cheng'feng'xing'lang	谓趁机挑起事端。
乘风转舵	cheng'feng'zhuan'duo	谓顺随情势改变态度。
乘高决水	cheng'gao'jue'shui	凭借地势居高临下，决口放水。比喻费力小，收效大。
乘机打劫	cheng'ji'da'jie	谓利用机会掠夺钱财。
乘坚策肥	cheng'jian'ce'fei	乘好车，驱良马。形容生活奢华。
乘坚驱良	cheng'jian'qu'liang	见“乘坚策肥”。
乘间抵隙	cheng'jian'di'xi	趁机钻空子。
乘间伺隙	cheng'jian'si'xi	同“乘间抵隙”。
乘利席胜	cheng'li'xi'sheng	凭借着胜利的形势。
乘龙佳婿	cheng'long'jia'xu	比喻好女婿。
乘龙快婿	cheng'long'kuai'xu	同“乘龙佳婿”。
乘龙配凤	cheng'long'pei'feng	比喻得佳偶，结良缘。
乘鸾跨凤	cheng'luan'kua'feng	比喻结成美好的姻缘。
乘轻驱肥	cheng'qing'qu'fei	同“乘坚策肥”。
乘热打铁	cheng're'da'tie	比喻做事抓紧时机，加速进行。
乘人之危	cheng'ren'zhi'wei	趁着别人有困难的时候，加以要挟或陷害。
乘势使气	cheng'shi'shi'qi	仗势逞性子。
乘顺水船	cheng'shun'shui'chuan	比喻顺势行事。
乘隙捣虚	cheng'xi'dao'xu	趁空子，攻虚弱。
乘隙而入	cheng'xi'er'ru	同“乘虚而入”。
乘险抵巇	cheng'xian'di'xi	冒险钻空子。
乘虚蹈隙	cheng'xu'dao'xi	又作：切中窾窍。比喻叩击中节。
乘虚而入	cheng'xu'er'ru	趁其空虚而侵入。
乘舆播越	cheng'yu'bo'yue	谓天子流亡在外。
乘云行泥	cheng'yun'xing'ni	比喻地位高下悬殊。
惩恶劝善	cheng'e'quan'shan	惩罚邪恶，劝勉向善。语本《左传·成公十四年》：“《春秋》之称微而显，志而晦……惩恶而劝善。非圣人谁能修之？”
惩忿窒欲	cheng'fen'zhi'yu	谓克制愤怒，杜塞情欲。
惩忿窒欲	cheng'fen'zhi'yu	见“惩忿窒欲”。
惩羹吹齑	cheng'geng'chui'ji	人被滚汤烫过，以后吃冷菜也要吹一下。羹，滚汤；齑，细切的肉菜，冷食品。比喻戒惧过甚。语出《楚辞·九章·惜诵》：“惩於羹者而吹齑兮，何不变此志也？”
惩前毖后	cheng'qian'bi'hou	谓从以前的错误或失败中吸取教训，使以后不至重犯。语本《诗·周颂·小毖》：“予其惩而毖后患。”
惩一戒百	cheng'yi'jie'bai	见“惩一警百”。
惩一儆百	cheng'yi'jing'bai	见“惩一警百”。
惩一警百	cheng'yi'jing'bai	谓惩罚一人以警戒众人。语本《汉书·尹翁归传》：“翁归治东海明察……其有所取也，以一警百，吏民皆服，恐惧改行自新。”
程门度雪	cheng'men'du'xue	见“程门立雪”。
程门飞雪	cheng'men'fei'xue	见“程门立雪”。
程门立雪	cheng'men'li'xue	《宋史·道学传二·杨时》：“扞时呴一日见颐，颐偶瞑坐，时与游酢侍立不去。颐既觉，则门外雪深一尺矣。”事亦见《二程语录》卷十七引侯仲良《侯子雅言》。后因以“程门立雪”为尊师重道的典故。
程式动作	cheng'shi'dong'zuo	戏剧术语。指经过艺术夸张、提炼加工而定型的规范化、格式化的表演动作。如中国传统戏曲中人物出场时整冠理髯，哀痛时扬袖，以及大将出征前“起霸”，策马奔驰时“趟马”等。
程硃理学	cheng'zhu'li'xue	指北宋程颢、程颐和南宋硃熹的理学。参见“程硃学派”。
程硃学派	cheng'zhu'xue'pai	宋代理学的主要派别。首创者为北宋程颢、程颐，集大成者为南宋硃熹。他们提倡性理，认为理为宇宙之本原，人性为理的体现。主张为学之道在“穷天理，去人欲”，其方法为“居敬穷理”，既作“敬”的修养功夫，又穷天下万物之理以致知。因为他们的学说基本一致，后人称之为程硃学派，也称程硃理学。由于封建统治阶级的大力提倡，该学派曾长期保持思想上的统治地位。
程硃之学	cheng'zhu'zhi'xue	指宋代程颢、程颐、硃熹的理学。
澄沙汰砾	cheng'sha'tai'li	谓除去杂质，使之纯洁。
澄神离形	cheng'shen'li'xing	形容用心太专，如痴如呆。
澄思渺虑	cheng'si'miao'lv	深思远虑。
逞工衒巧	cheng'gong'xuan'qiao	炫耀工巧。
逞怪披奇	cheng'guai'pi'qi	炫耀奇异。
逞娇呈美	cheng'jiao'cheng'mei	谓花草显示出美丽的颜色。
逞娇斗媚	cheng'jiao'dou'mei	又作：争娇斗媚。形容竞相撒娇献媚的样子。
逞奇眩异	cheng'qi'xuan'yi	炫耀奇异。
逞强称能	cheng'qiang'cheng'neng	炫耀卖弄自己的才能和本事。
逞强好胜	cheng'qiang'hao'sheng	谓显示自己能力强并想胜过别人。
逞心如意	cheng'xin'ru'yi	又作：称心如意。
逞妍斗色	cheng'yan'dou'se	形容花兒盛开，竞相逞美。
逞异夸能	cheng'yi'kua'neng	施展奇异本事，夸耀能力高强。
骋耆奔欲	cheng'qi'ben'yu	谓随自己的嗜欲而奔走求取。
骋嗜奔欲	cheng'shi'ben'yu	见“骋耆奔欲”。
秤不离铊	cheng'bu'li'ta	秤和砣原为一整套衡具，喻事物之相联系者不可使其分离。
秤薪量水	cheng'xin'liang'shui	谓勤俭持家。
吃喝玩乐	chi'he'wan'le	谓过恣意享乐的生活。
吃惊受怕	chi'jing'shou'pa	受惊骇。
吃里扒外	chi'li'ba'wai	见“吃里爬外”。
吃里爬外	chi'li'pa'wai	亦作“吃里扒外”。比喻受这一方好处，却暗为另一方效劳。
吃一堑，长一智	chi'yi'qian'-'chang'yi'zhi	智】	受一次挫折，长一分见识。堑，壕沟，比喻挫折、教训。
鸱目虎吻	chi'mu'hu'wen	如鸱之目，如虎之口。奸狠凶恶貌。
鸱视虎顾	chi'shi'hu'gu	见“鸱视狼顾”。
鸱视狼顾	chi'shi'lang'gu	①如鸱鸟举首而视，如狼反顾。②形容人的凶狠贪戾。
鸱张门户	chi'zhang'men'hu	树立门户，标榜门庭。
鸱张鼠伏	chi'zhang'shu'fu	比喻时而嚣张，时而隐蔽。
鸱张蚁聚	chi'zhang'yi'ju	喻指如鸱嚣张，如蚁聚集。
鸱张鱼烂	chi'zhang'yu'lan	《旧唐书·僖宗纪》：“初则狐假鸱张，自谓骁雄莫敌；旋则鸟焚鱼烂，无非破败而终。”后以“鸱张鱼烂”比喻外表嚣张，内则溃烂而自行覆灭。
嗤之以鼻	chi'zhi'yi'bi	用鼻子吭气，表示看不起。
痴男騃女	chi'nan'si'nv	又作：痴兒騃女。
痴男怨女	chi'nan'yuan'nv	谓沉迷于爱情而有怨恨的男女。
痴人说梦	chi'ren'shuo'meng	语本《五灯会元·龙门远禅师法嗣·乌巨道行禅师》：“祖师西来，直指人心，见性成佛。痴人面前，不得不梦。”后以“痴人说梦”指凭妄想说不可靠或根本办不到的话。
痴鼠拖姜	chi'shu'tuo'jiang	比喻不聪明的人自找麻烦。
痴思妄想	chi'si'wang'xiang	又作：痴心妄想。
痴心妄想	chi'xin'wang'xiang	谓一心抱着不切实际的想法。
痴云腻雨	chi'yun'ni'yu	见“痴云騃雨”。
痴云騃雨	chi'yun'si'yu	形容男女沉迷恋情。
絺辞绘句	chi'ci'hui'ju	同“絺句绘章”。
絺绘章句	chi'hui'zhang'ju	同“絺句绘章”。
絺句绘章	chi'ju'hui'zhang	雕琢文辞，修饰章句。
絺章绘句	chi'zhang'hui'ju	同“絺句绘章”。
絺章饰句	chi'zhang'shi'ju	同“絺句绘章”。
螭鬽魍魉	chi'mei'wang'liang	见“螭魅罔两”。
螭魅罔两	chi'mei'wang'liang	亦作“螭魅魍魉”。亦作“螭鬽魍魉”。传说中川泽山林的妖怪。后用以比喻形形色色的坏人。螭，通“魑”。
螭魅魍魉	chi'mei'wang'liang	见“螭魅罔两”。
螭盘虎踞	chi'pan'hu'ju	犹虎踞龙盘。
魑魅罔两	chi'mei'wang'liang	见“魑魅魍魉”。
魑魅魍魉	chi'mei'wang'liang	害人的鬼怪的统称。
池酒林胾	chi'jiu'lin'zi	《史记·殷本纪》：“扞帝纣呴大冣乐戏於沙丘，以酒为池，县肉为林，使男女倮相逐其閒，为长夜之饮。”后遂以“池酒林胾”形容酒肉极多，生活奢侈。
池鱼幕燕	chi'yu'mu'yan	比喻处境危险极易遭殃的人。
池鱼堂燕	chi'yu'tang'yan	比喻无辜受祸。
池鱼之祸	chi'yu'zhi'huo	见“池鱼之殃”。
池鱼之虑	chi'yu'zhi'lv	谓担忧无端受累遭灾。
池鱼之殃	chi'yu'zhi'yang	《太平广记》卷四六六引汉应劭《风俗通》：“城门失火，祸及池鱼。旧说：池仲鱼，人姓字也，居宋城门，城门失火，延及其家，仲鱼烧死。又云：宋城门失火，人汲取池中水，以沃灌之。池中空竭，鱼悉露死。喻恶之滋，并伤良谨也。”后以“池鱼之殃”喻因牵连而无端遭到的灾祸。
驰风骋雨	chi'feng'cheng'yu	又作：乘风驾雨。
驰高鹜远	chi'gao'wu'yuan	又作：好高骛远。
驰魂宕魄	chi'hun'dang'po	形容振撼心灵。
驰魂夺魄	chi'hun'duo'po	见“驰魂宕魄”。
驰声走誉	chi'sheng'zou'yu	名声传扬。
驰志伊吾	chi'zhi'yi'wu	《后汉书·臧宫传论》：“臧宫、马武之徒，抚鸣剑而抵掌，志驰於伊吾之北矣。”伊吾，今新疆哈密。后因以“驰志伊吾”表示向往在边塞建功立业。
迟徊不决	chi'huai'bu'jue	又作：迟疑不决。
迟徊观望	chi'huai'guan'wang	又作：迟疑观望。
迟回观望	chi'hui'guan'wang	同“迟疑观望”。
迟眉钝眼	chi'mei'dun'yan	谓眼神呆滞，不灵活。
迟日旷久	chi'ri'kuang'jiu	又作：旷日持久。
迟疑不定	chi'yi'bu'ding	又作：迟疑不决。
迟疑不断	chi'yi'bu'duan	又作：迟疑不决。
迟疑不决	chi'yi'bu'jue	犹豫疑惑，不能决定。决，亦写作“决”。
迟疑顾望	chi'yi'gu'wang	又作：迟疑观望。
迟疑观望	chi'yi'guan'wang	谓犹豫等待，不作决定。
迟疑未决	chi'yi'wei'jue	又作：迟疑不决。
持螯把酒	chi'ao'ba'jiu	南朝宋刘义庆《世说新语·任诞》载：晋代嗜酒的毕卓曾说：一手拿着蟹螯，一手捧着酒杯，便足以了一生。因以“持螯把酒”形容秋季吃蟹饮酒之乐。
持筹握算	chi'chou'wo'suan	计算；精打细算。
持戈试马	chi'ge'shi'ma	比喻作好准备，跃跃欲试。
持衡拥璇	chi'heng'yong'xuan	比喻执掌权柄。璇、衡，北斗七星中的二星名。
持禄养交	chi'lu'yang'jiao	谓结交权贵以保持禄位。
持满戒盈	chi'man'jie'ying	端盛满之水而留心不外溢。比喻居高位而能警戒自己不骄傲自满。
持平之论	chi'ping'zhi'lun	谓公正合理的议论和意见。
持权合变	chi'quan'he'bian	以权宜之计适应已经变化的局面。
持人长短	chi'ren'chang'duan	谓抓住他人的缺点过失作为把柄，加以攻击。
持橐簪笔	chi'tuo'zan'bi	谓侍从之臣携带书和笔，以备顾问。
持危扶颠	chi'wei'fu'dian	扶持危殆局面。语本《论语·季氏》：“危而不持，颠而不扶。”
持盈保泰	chi'ying'bao'tai	谓处在极盛时要谦逊谨慎以保持平安。
持盈守成	chi'ying'shou'cheng	保持已成的盛业。
持正不阿	chi'zheng'bu'a	持守公正正派，不迎合阿谀。
持之以恆	chi'zhi'yi'heng	亦作“持之以忄互”。谓有恆心，长期坚持下去。
持之以忄互	chi'zhi'yi'xin'hu		见“持之以恆”。
持之有故	chi'zhi'you'gu	谓立论有根据。
尺板斗食	chi'ban'dou'shi	旧时形容小官位低禄少。
尺兵寸铁	chi'bing'cun'tie	比喻微小的武力。
尺波电谢	chi'bo'dian'xie	谓人世短促，如波逝电闪。
尺布斗粟	chi'bu'dou'su	汉文帝弟淮南王刘长谋反，事败被废，徙居蜀郡严道县，途中不食而死。民间为此作歌谓：“一尺布，尚可缝；一斗粟，尚可舂。兄弟二人不能相容。”事见《史记·淮南衡山列传》。后多以“尺布斗粟”讥兄弟不和。
尺步绳趋	chi'bu'sheng'qu	谓行有准绳，循法度。
尺寸千里	chi'cun'qian'li	形容登高所见，千里远景，如在尺寸之间。
尺短寸长	chi'duan'cun'chang	见“尺有所短，寸有所长”。
尺二秀才	chi'er'xiu'cai	旧时用以讥讽写俗字的书生。“尺二”即指当时“尽”字的俗体“尽”字。
尺二冤家	chi'er'yuan'jia	指众多的求书画者。尺二，指卷轴高度。
尺幅寸缣	chi'fu'cun'jian	指小幅书画。
尺籍伍符	chi'ji'wu'fu	指记载军令、军功的簿籍和军士中各伍互相作保的守则。
尺山寸水	chi'shan'cun'shui	每一小塊山水。
尺水丈波	chi'shui'zhang'bo	比喻因小事而引起大风波。语本唐孟郊《君子勿郁郁士有谤毁者作诗以赠之》之一：“须知一尺水，日夜增高波。”
尺有所短	chi'you'suo'duan	比喻事物有其短处，并非在所有的情况下都是合适的。
尺瑜寸瑕	chi'yu'cun'xia	大塊美玉而小有疵病。比喻良才而有小缺点。
尺竹伍符	chi'zhu'wu'fu	本指记载军令、军功的簿籍和军士中各伍互相作保的守则。亦借指军队。
侈侈不休	chi'chi'bu'xiu	说话没完没了；唠叨。
侈恩席宠	chi'en'xi'chong	张扬恩遇凭恃宠幸。
侈丽闳衍	chi'li'hong'yan	华丽繁富。多用以指文辞。
侈人观听	chi'ren'guan'ting	谓加强人们在观感听觉上的印象。
侈衣美食	chi'yi'mei'shi	侈衣，华美的衣服；美食，鲜美的食物。言衣食俱精。
侈纵偷苟	chi'zong'tou'gou	奢侈放纵，苟且偷生。
齿白脣红	chi'bai'chun'hong	形容年轻美貌。
齿弊舌存	chi'bi'she'cun	谓刚者易折，柔者难毁。语本汉刘向《说苑·敬慎》：“老子曰：‘夫舌之存也，岂非以其柔耶？齿之亡也，岂非以其刚耶？’”
齿甘乘肥	chi'gan'cheng'fei	食美味，骑骏马。形容生活豪奢。
齿过肩随	chi'guo'jian'sui	谓尊礼长者。
齿豁头童	chi'huo'tou'tong	齿缺发秃。指老态。
齿颊挂人	chi'jia'gua'ren	谓为人们所称道。
齿颊生香	chi'jia'sheng'xiang	嘴边觉有香气生出。形容谈及之事使人产生美感。
齿剑如归	chi'jian'ru'gui	又作：视死如归。
齿落舌钝	chi'luo'she'dun	年老掉齿，说话不清楚。
齿如编贝	chi'ru'bian'bei	同“齿如齐贝”。
齿如含贝	chi'ru'han'bei	同“齿如齐贝”。
齿如齐贝	chi'ru'qi'bei	形容牙齿整齐洁白。贝，白色螺壳。
齿若编贝	chi'ruo'bian'bei	同“齿如齐贝”。
齿少气锐	chi'shao'qi'rui	见“齿少心锐”。
齿少心锐	chi'shao'xin'rui	年轻气盛，锐意进取。
齿危发秀	chi'wei'fa'xiu	年高眉秀。
齿牙为猾	chi'ya'wei'hua	谓谗言造成灾祸。
齿牙为祸	chi'ya'wei'huo	见“齿牙为猾”。
齿牙馀惠	chi'ya'yu'hui	谓帮人说好话。
齿牙馀慧	chi'ya'yu'hui	见“齿牙馀惠”。
齿牙馀论	chi'ya'yu'lun	随口称誉的话。
齿牙之猾	chi'ya'zhi'hua	见“齿牙为猾”。
耻居王后	chi'ju'wang'hou	《新唐书·文艺传上·王勃》：“勃与杨烱、卢照邻、骆宾王皆以文章齐名，天下称‘王、杨、卢、骆’，号‘四杰’。烱尝曰：‘吾窆碓诼前，耻居王后。’议者谓然。”后因以“耻居王后”指在文名上耻于处在不及己者之后。
耻与哙伍	chi'yu'kuai'wu	汉初，韩信由楚王降封为淮阴侯，日夜怨望。有一次，他顺便去看望樊哙，樊哙跪拜送迎。出来后，韩信笑着说：“生乃与哙等为伍。”见《史记·淮阴侯列传》。后以“耻与哙伍”指不愿与粗鄙庸碌之人为伍。
叱嗟风云	chi'jie'feng'yun	同“叱咤风云”。
叱咤风云	chi'zha'feng'yun	形容声势、威力极大。
赤膊上阵	chi'bo'shang'zhen	①不穿盔甲，裸露上身出阵交战。比喻不顾一切，勇猛战斗。②比喻坏人撕去伪装，公然做坏事。
赤胆忠肝	chi'dan'zhong'gan	见“赤胆忠心”。
赤胆忠心	chi'dan'zhong'xin	形容极其忠诚。
赤地千里	chi'di'qian'li	形容灾荒严重或战乱频仍，大片土地寸草不生或荒无人烟。
赤口白舌	chi'kou'bai'she	①古代迷信谓主口舌争讼的恶神。旧俗多于端午节书帖悬门以禳之。②平白无故。
赤口烧城	chi'kou'shao'cheng	见“赤舌烧城”。
赤舌烧城	chi'she'shao'cheng	比喻谗言为害极其严重。
赤身露体	chi'shen'lu'ti	光着身体。
赤身裸体	chi'shen'luo'ti	见“赤身露体”。
赤手空拳	chi'shou'kong'quan	两手空空，一无所有。
赤手起家	chi'shou'qi'jia	形容在条件很差的情况下创立起一番家业。
赤体上阵	chi'ti'shang'zhen	不穿盔甲，裸露上身出阵交战。事本《三国演义》第五九回：“许褚性起，飞回阵中，卸下盔甲，浑身筋突，赤体提刀，来与马超决战。”后比喻不顾一切、猛打猛冲的作风。
赤县神州	chi'xian'shen'zhou	战国齐人驺衍（一作邹衍）创立“大九州”学说，谓“中国名曰赤县神州。赤县神州内自有九州，禹之序九州是也，不得为州数。中国外如赤县神州者九，乃所谓九州也。”见《史记·孟子荀卿列传》。后以借指中原或中国。
赤心报国	chi'xin'bao'guo	竭尽忠心，报效国家。
赤心奉国	chi'xin'feng'guo	见“赤心报国”。
赤子之心	chi'zi'zhi'xin	喻纯洁善良的心地。
敕始毖终	chi'shi'bi'zhong	自始至终警饬谨慎。
充栋汗牛	chong'dong'han'niu	谓书籍堆得高及栋梁，多至牛马运得出汗。形容藏书或著述之富。语出唐柳宗元《陆文通先生墓表》：“其为书，处则充栋宇，出则汗牛马。”
充栋盈车	chong'dong'ying'che	堆满屋子，装满车。形容书籍很多。
充耳不闻	chong'er'bu'wen	①塞住耳朵故意不听。形容拒绝听取别人的意见。②形容专心一致，什么声音也听不见。
充饥画饼	chong'ji'hua'bing	喻借助空想安慰自己。
充类至尽	chong'lei'zhi'jin	谓用同类事物比照类推，把道理引申到极点。
充天塞地	chong'tian'sai'di	指整个宇宙。
冲风冒雨	chong'feng'mao'yu	谓不避风雨之苦。
冲风破浪	chong'feng'po'lang	形容在水道中迅猛前进。
冲锋陷坚	chong'feng'xian'jian	又作：冲锋陷阵。
冲锋陷锐	chong'feng'xian'rui	又作：冲锋陷阵。
冲锋陷阵	chong'feng'xian'zhen	①向前冲击，攻破敌阵。形容作战勇敢。②泛指勇于进击。
冲冠发怒	chong'guan'fa'nu	见“冲冠怒发”。
冲冠怒发	chong'guan'nu'fa	形容极为愤怒。
冲冠眦裂	chong'guan'zi'lie	形容愤怒到极点。眦裂，睁裂眼眶。语本《史记·项羽本纪》：“哙即带剑拥盾入军门……瞋目视项王，头发上指，目眦尽裂。”
冲口而出	chong'kou'er'chu	谓不加思索说出口来。
冲州过府	chong'zhou'guo'fu	见“冲州撞府”。
冲州撞府	chong'zhou'zhuang'fu	指在江湖上到处漂荡，行止无定。
冲州撞府	chong'zhou'zhuang'fu	谓到处闯荡。
舂容大雅	chong'rong'da'ya	指文章气度雍容，用辞典雅。
崇本抑末	chong'ben'yi'mo	注重根本，轻视枝末。古代“本”多指农业，“末”多指工商业。
崇论吰议	chong'lun'hong'yi	见“崇论闳议”。
崇论宏议	chong'lun'hong'yi	见“崇论闳议”。
崇论闳议	chong'lun'hong'yi	亦作“崇论宏议”。亦作“崇论谹议”。亦作“崇论吰议”。原谓高论博议，后指高明宏大的议论。
崇论谹议	chong'lun'hong'yi	见“崇论闳议”。
崇山峻岭	chong'shan'jun'ling	高大陡峻的山岭。
崇雅黜浮	chong'ya'chu'fu	谓在文风上崇尚雅正，摈弃浮华。
崇墉百雉	chong'yong'bai'zhi	形容城墙高大。
蟲臂拒辙	chong'bi'ju'zhe	又作：螳臂挡车。比喻以小敌大，力量悬殊。
蟲臂鼠肝	chong'bi'shu'gan	意谓造物赋形，变化无定，人亦可以成为微不足道的虫臂鼠肝。只有随缘而化，才能所遇皆适。语本《庄子·大宗师》：“以汝为鼠肝乎？以汝为蟲臂乎？”成玄英疏：“叹彼大造，弘普无私，偶尔为人，忽然返化。不知方外適往何道，变作何物。将汝五藏为鼠之肝，或化四支为蟲之臂。任化而往，所遇皆適也。”
蟲鸣螽跃	chong'ming'zhong'yue	《诗·召南·草虫》：“喓喓草蟲，趯趯阜螽。”郑玄注：“草蟲鸣，阜螽跃而从之。”后因以“蟲鸣螽跃”比喻固有的自然规律。
蟲沙猿鹤	chong'sha'yuan'he	《艺文类聚》卷九十引晋葛洪《抱朴子》：“周穆王南征，一军尽化，君子为猿为鹤，小人为蟲为沙。”后因以“蟲沙猿鹤”称战死的将卒。
蟲书鸟迹	chong'shu'niao'ji	指古代的鸟虫书。借指变化莫测、难以辨认的书体。
蟲书鸟篆	chong'shu'niao'zhuan	鸟虫书。比喻无法认读的字，借指外国文字。
蟲言鸟迹	chong'yan'niao'ji	上古的语言文字。借指上古时期。
蟲叶成字	chong'ye'cheng'zi	《汉书·五行志中之下》：“昭帝时，上林苑中大柳树断仆地，一朝起立，生枝叶，有蟲食其叶，成文字，曰‘公孙病已立’。”病已，汉宣帝名。后以“蟲叶成字”指称谶纬。
宠柳娇花	chong'liu'jiao'hua	惹人宠爱的柳色、娇艳的花枝。形容春色。
宠辱不惊	chong'ru'bu'jing	受宠受辱都无动于衷。谓将得失置于度外。
宠辱若惊	chong'ru'ruo'jing	谓君王以居下为道，得之则惊喜，失之则惊恐。
抽丁拔楔	chou'ding'ba'xie	比喻解决疑难。丁，“钉”的古字。
抽黄对白	chou'huang'dui'bai	谓只求对仗工稳。
抽梁换柱	chou'liang'huan'zhu	谓改换事物的形式或内容。
抽祕骋妍	chou'mi'cheng'yan	抒发深意，施展美才。
抽胎换骨	chou'tai'huan'gu	犹脱胎换骨。
抽薪止沸	chou'xin'zhi'fei	抽去正在燃烧的柴薪以止锅水沸腾。比喻从根本上解决问题。
仇人见面，分外眼红	chou'ren'jian'mian'-'fen'wai'yan'hong	外眼红】	见“仇人相见，分外眼红”。
仇人相见，分外明白	chou'ren'xiang'jian'-'fen'wai'ming'bai	外明白】	见“仇人相见，分外眼明”。
仇人相见，分外眼红	chou'ren'xiang'jian'-'fen'wai'yan'hong	外眼红】	谓当敌对的双方彼此相逢时，格外怒不可遏。
仇人相见，分外眼明	chou'ren'xiang'jian'-'fen'wai'yan'ming	外眼明】	谓当敌对的双方相逢时，彼此对对方都格外警觉和敏感。
仇人相见，分外眼睁	chou'ren'xiang'jian'-'fen'wai'yan'zheng	外眼睁】	同“仇人相见，分外眼明”。
绸缪桑土	chou'mou'sang'tu	犹绸缪未雨。
绸缪帷幄	chou'mou'wei'wo	犹运筹帷幄。谓在军营帐幕之中谋划军国大事。
绸缪帷帐	chou'mou'wei'zhang	见“绸缪帷幄”。
绸缪未雨	chou'mou'wei'yu	《诗·豳风·鸱鸮》：“迨天之未阴雨，彻彼桑土，绸缪牖户。”孔颖达疏：“毛以为自说作巢至苦，言己及天之未阴雨之时，剥彼桑根以缠绵其牖户，乃得成此室巢。”后以“绸缪未雨”或“未雨绸缪”比喻事前作好准备工作。
绸缪牖户	chou'mou'you'hu	犹绸缪未雨。
绸缪帐扆	chou'mou'zhang'yi	见“绸缪帷幄”。
畴咨之忧	chou'zi'zhi'you	指人才难求的忧虑。
愁肠百结	chou'chang'bai'jie	形容极其忧愁、烦恼。
愁肠九转	chou'chang'jiu'zhuan	谓重重忧愁萦绕心怀。
愁红惨绿	chou'hong'can'lv	谓经风雨摧残的败花残叶。
愁红怨绿	chou'hong'yuan'lv	见“愁红惨绿”。
愁眉不展	chou'mei'bu'zhan	谓由于忧愁而双眉紧锁。形容心事重重。
愁眉蹙额	chou'mei'cu'e	因发愁而紧皱眉头。
愁眉苦脸	chou'mei'ku'lian	形容忧思重重，神色悲苦。
愁眉苦眼	chou'mei'ku'yan	见“愁眉苦脸”。
愁眉泪眼	chou'mei'lei'yan	皱着眉头，掉下眼泪。形容愁苦悲伤。
愁潘病沈	chou'pan'bing'shen	晋潘岳因忧愁而早生白发，南朝梁沈约因病而瘦减腰围。因以“愁潘病沈”泛指烦恼和疾病。
愁山闷海	chou'shan'men'hai	喻愁闷极多。
愁云惨雾	chou'yun'can'wu	形容令人愁闷凄惨的景象。
稠人广众	chou'ren'guang'zhong	指人群众多。
稠人广坐	chou'ren'guang'zuo	又作：公共场合。
酬功给效	chou'gong'gei'xiao	赏赐有功劳者。
踌躇满志	chou'chu'man'zhi	心满意足，从容自得的样子。
丑态百出	chou'tai'bai'chu	种种丑相都表现了出来。
臭腐神奇	chou'fu'shen'qi	《庄子·知北游》：“是其所美者为神奇，其所恶者为臭腐，臭腐复化为神奇，神奇复化为臭腐。故曰，通天下一气耳。”意谓同一事物，其是非美丑，随人之好恶而异。后以之谓化无用为有用；化废为宝。
臭名昭著	chou'ming'zhao'zhu	谓坏名声谁都知道。
臭味相投	chou'wei'xiang'tou	即气味相投。指思想情趣相同的人彼此合得来。臭，亦读chòu。今多用于贬义。语本汉蔡邕《玄文先生李休碑》：“凡其亲昭朋徒、臭味相与，大会而葬之。”
出陈易新	chu'chen'yi'xin	犹吐故纳新。去掉旧的换成新的。
出丑放乖	chu'chou'fang'guai	又作：出乖露丑。
出丑扬疾	chu'chou'yang'ji	暴露丑恶。
出出律律	chu'chu'lv'lv	象声词。
出处进退	chu'chu'jin'tui	出仕或隐退。
出处殊涂	chu'chu'shu'tu	亦作“出处殊途”。谓出仕与隐居的态度各不相同。
出处殊途	chu'chu'shu'tu	见“出处殊涂”。
出处语默	chu'chu'yu'mo	出仕和隐退，发言和沉默。语本《易·系辞上》：“君子之道，或出或处，或默或语。”
出词吐气	chu'ci'tu'qi	犹谈吐。
出敌不意	chu'di'bu'yi	亦作“出敌意外”。谓行动出于敌方意料之外。
出敌意外	chu'di'yi'wai	见“出敌不意”。
出尔反尔	chu'er'fan'er	①《孟子·梁惠王下》：“曾子曰：‘戒之戒之！出乎尔者，反乎尔者也。’”后因用“出尔反尔”表示你如何对待别人，别人也如何对待你的意思。②指前后言行自相矛盾，反复无常。
出公忘私	chu'gong'wang'si	出于公心忘掉私情。
出谷迁乔	chu'gu'qian'qiao	从低处移到高处。《诗·小雅·伐木》：“出自幽谷，迁于乔木。”宋王之道《青玉案·有怀轩车山旧隐》词：“黄鸝休叹青春暮，出谷迁乔旧家句，天意从人还许诉。”本指鸟出自深谷，移居高木，后以“乔迁”为祝贺别人迁居之词。
出乖露丑	chu'guai'lu'chou	出丑；丢脸。
出乖弄丑	chu'guai'nong'chou	见“出乖露丑”。
出鬼入神	chu'gui'ru'shen	谓变化多端，不可捉摸。
出何典记	chu'he'dian'ji	诘问见于何书，有何根据。
出何经典	chu'he'jing'dian	谓不知所说出自何书，有无根据。
出乎反乎	chu'hu'fan'hu	又作：出尔反尔。谓翻悔或说了不照着做。
出乎意表	chu'hu'yi'biao	出于意料之外。
出乎意料	chu'hu'yi'liao	出于意料之外。
出乎意外	chu'hu'yi'wai	出于意料之外。
出乎预料	chu'hu'yu'liao	见“出乎意料”。
出将入相	chu'jiang'ru'xiang	谓文武双全，出战领兵为将，入阁理事为相。亦泛指官居高位。
出口成章	chu'kou'cheng'zhang	脱口而出的话都成文章。形容口才好，或文思敏捷。
出口入耳	chu'kou'ru'er	谓言出甲口，入于乙耳，不为他人所知。《左传·昭公二十年》：“王曰：‘言出於余口，入於尔耳，谁告建也？’”
出类拔萃	chu'lei'ba'cui	《孟子·公孙丑上》：“圣人之於民，亦类也。出於其类，拔乎其萃，自生民以来，未有盛於孔子也。”拔，超出；类，同类；萃，原为草丛生的样子，引申指同类丛聚。后以“出类拔萃”形容卓越出众，不同一般。
出没不常	chu'mei'bu'chang	出现隐没都无规律，捉摸不定。
出没无常	chu'mei'wu'chang	见“出没不常”。
出门合辙	chu'men'he'zhe	按同一规格，闭门造车子，用起来自然合辙。《景德传灯录·匡悟禅师》：“问：‘如何是闭门造车？’师曰：‘活计一物无。’曰：‘如何是出门合辙？’师曰：‘坐地进长安。’”明何景明《述归赋》：“至其矩法则闭户造车，出门合辙，不烦登途比试矣。”因以比喻才学适合社会需要。
出门如宾	chu'men'ru'bin	出外做事象接待贵宾那样认真谨慎。
出门应辙	chu'men'ying'zhe	犹出门合辙。
出谋划策	chu'mou'hua'ce	出主意，想办法。
出内之吝	chu'nei'zhi'lin	见“出纳之吝”。
出纳之吝	chu'na'zhi'lin	亦作“出内之吝”。舍不得拿出去，出手小气。
出奴入主	chu'nu'ru'zhu	唐韩愈《原道》：“其言道德仁义者，不入於杨，则入於墨，不入於老，则入於佛；入於彼，必出於此，入者主之，出者奴之。”后以“出奴入主”谓挟门户成见。
出其不备	chu'qi'bu'bei	又作：出其不意。
出其不意，攻其不备	chu'qi'bu'yi'-'gong'qi'bu'bei	其不备】	见“出其不意，攻其无备”。
出其不意，攻其无备	chu'qi'bu'yi'-'gong'qi'wu'bei	其无备】	语出《孙子·计》。原谓出兵攻击对方不防备的地方。后亦指行动出乎人的意料。
出其不意，掩其不备	chu'qi'bu'yi'-'yan'qi'bu'bei	其不备】	见“出其不意，攻其无备”。
出其不意	chu'qi'bu'yi	《孙子·计》：“攻其无备，出其不意。”原谓出兵攻击对方不防备的地方。后多以“出其不意”指行动出乎人的意料。
出其不虞	chu'qi'bu'yu	又作：出其不意。
出奇不穷	chu'qi'bu'qiong	见“出奇无穷”。
出奇划策	chu'qi'hua'ce	又作：出谋划策。
出奇取胜	chu'qi'qu'sheng	见“出奇制胜”。
出奇无穷	chu'qi'wu'qiong	谓多出奇兵，多用奇计。比喻变化多端，使人难以捉摸。
出奇制胜	chu'qi'zhi'sheng	谓用奇兵奇计战胜敌人。亦泛指用常人意想不到的方法、手段来取得好的效果。
出奇致胜	chu'qi'zhi'sheng	见“出奇制胜”。
出浅入深	chu'qian'ru'shen	又作：深入浅出。
出群拔萃	chu'qun'ba'cui	见“出类拔萃”。
出人头地	chu'ren'tou'di	超出一般人；高人一等。
出人望外	chu'ren'wang'wai	犹出人意表。
出人意表	chu'ren'yi'biao	超出人们的意料之外。
出人意料	chu'ren'yi'liao	超出人们的意料。
出人意外	chu'ren'yi'wai	同“出人意表”。
出入将相	chu'ru'jiang'xiang	犹出将入相。
出入人罪	chu'ru'ren'zui	又作：枉断人罪。
出入神鬼	chu'ru'shen'gui	又作：神出鬼没。
出入生死	chu'ru'sheng'si	出生入死。
出入无间	chu'ru'wu'jian	出入无间隔，又作：进出自由。
出神入定	chu'shen'ru'ding	形容聚精会神。
出神入化	chu'shen'ru'hua	形容技艺达到绝妙境界。
出生入死	chu'sheng'ru'si	《老子》：“出生入死，生之徒十有三，死之徒十有三。”王弼注：“出生地，入死地。”《韩非子·解老》：“人始於生而卒於死。始谓之出，卒谓之入。故曰：出生入死。”原谓从出生到死去。后用以形容冒生命危险，随时有死的可能。
出圣入神	chu'sheng'ru'shen	谓神奇高妙。
出师无名	chu'shi'wu'ming	谓没有正当理由而出兵征伐。
出师有名	chu'shi'you'ming	有正当理由进行征伐。
出世超凡	chu'shi'chao'fan	谓高超脱俗。
出世离群	chu'shi'li'qun	脱离人世。
出手得卢	chu'shou'de'lu	比喻事情一举获胜。古时樗蒲戏中一掷五子俱黑叫“卢”，是最胜之采。
出水芙蓉	chu'shui'fu'rong	水面上初放的荷花。多以喻诗文的清新或女子的艳丽。
出死断亡	chu'si'duan'wang	谓效死捐生。
出死入生	chu'si'ru'sheng	①从死亡里获救。②犹出生入死。
出头露面	chu'tou'lu'mian	①具体显示出来。②在公共场所出现。③犹出人头地，亦指在众人面前表现自己。
出文入武	chu'wen'ru'wu	谓文武兼备。
出言不逊	chu'yan'bu'xun	说话傲慢不客气。
出言成章	chu'yan'cheng'zhang	又作：出口成章。
出言吐词	chu'yan'tu'ci	见“出言吐气”。
出言吐气	chu'yan'tu'qi	又作：谈吐。指说话。
出言吐语	chu'yan'tu'yu	见“出言吐气”。
出言无状	chu'yan'wu'zhuang	说话傲慢无礼。
出一头地	chu'yi'tou'di	宋欧阳修《与梅圣俞书》：“读轼（苏轼）书，不觉汗出。快哉快哉！老夫当避路，放他出一头地也。”谓当避开此人让其高出众人一头之地。后以“出一头地”喻高人一着。
出夷入险	chu'yi'ru'xian	出入于安危之中。
出幽迁乔	chu'you'qian'qiao	语出《诗·小雅·伐木》：“出自幽谷，迁于乔木。”后以“出幽迁乔”比喻人的境遇好转或职位升迁。
出幽升高	chu'you'sheng'gao	又作：出谷迁乔。
出有入无	chu'you'ru'wu	出入于有无之中。
出於意表	chu'yu'yi'biao	谓出乎人的意料之外。
出於意外	chu'yu'yi'wai	见“出於意表”。
出舆入辇	chu'yu'ru'nian	谓动必乘车。
出语成章	chu'yu'cheng'zhang	见“出口成章”。
出云入泥	chu'yun'ru'ni	谓自己一旦青云直上，便不惜将旧时朋友踩入泥中。喻人情浇薄，世态炎凉。
出震继离	chu'zhen'ji'li	谓帝王登基即位。
出自意外	chu'zi'yi'wai	出于意料之外。
初出茅庐	chu'chu'mao'lu	东汉末，诸葛亮隐居南阳，刘备三顾茅庐，亮始出佐之。《三国演义》第三九回：“直须惊破曹公胆，初出茅庐第一功。”后用以谓初涉世致用，阅历不深。
初露锋芒	chu'lu'feng'mang	亦作“初试锋芒”。喻刚刚显示出某种威力或才干。
初露头角	chu'lu'tou'jiao	犹初露锋芒。
初生之犊	chu'sheng'zhi'du	刚出生的小牛。语出《庄子·知北游》：“德将为汝美，道将为汝居，汝瞳焉如新生之犊而无求其故！”后多用以喻单纯或勇猛的青年人。
初生之犊不惧虎	chu'sheng'zhi'du'bu'ju'hu	虎】	喻阅世不深的青年人敢说敢干，无所畏惧。
初生之犊不畏虎	chu'sheng'zhi'du'bu'wei'hu	虎】	同“初生之犊不惧虎”。
初试锋芒	chu'shi'feng'mang	见“初露锋芒”。
除暴安良	chu'bao'an'liang	铲除强暴势力，安抚善良百姓。
除残去秽	chu'can'qu'hui	扫除残馀，荡涤污秽。喻指彻底革新。
除恶务本	chu'e'wu'ben	铲除恶势力，必须杜绝根本。
除恶务尽	chu'e'wu'jin	语本《左传·哀公元年》：“臣闻‘树德莫如滋，除害莫如尽’。”后因以“除恶务尽”谓铲除恶势力必须彻底干净，不留后患。
除秽布新	chu'hui'bu'xin	又作：除旧布新。
除旧布新	chu'jiu'bu'xin	革除旧的，建立新的。
除狼得虎	chu'lang'de'hu	比喻除去一害又来一害。
锄强扶弱	chu'qiang'fu'ruo	铲除强暴，扶助弱小。
杵臼交	chu'jiu'jiao	后汉书·吴祐传》：“公沙穆来游太学，无资粮，乃变服客佣，为祐赁舂。祐与语大惊，遂共定交於杵臼之间。”后因以“杵臼交”指不计贫贱的交谊。
楚璧隋珍	chu'bi'sui'zhen	指和氏璧与隋侯珠。喻杰出的人才。
楚才晋用	chu'cai'jin'yong	比喻用才不当。
楚材晋用	chu'cai'jin'yong	《左传·襄公二十六年》：“声子通使於晋，还如楚。令尹子木与之语，问晋故焉，且曰：‘晋大夫与楚孰贤？’对曰：‘晋卿不如楚，其大夫则贤，皆卿材也。如杞梓、皮革，自楚往也。虽楚有材，晋实用之。’”后因以“楚材晋用”指引用别国人才或自己的人才外流为别人所用。
楚楚不凡	chu'chu'bu'fan	形容人才出众，不同寻常。
楚楚动人	chu'chu'dong'ren	形容姿容美好，动人心神。
楚楚可爱	chu'chu'ke'ai	形容陈设整齐，令人喜爱。
楚楚可怜	chu'chu'ke'lian	①形容形态或体态娇美可爱。②形容神情凄楚或处境不佳，令人怜悯。
楚楚可人	chu'chu'ke'ren	形容姿容清秀，使人惬意。
楚楚谡谡	chu'chu'su'su	形容风度清雅高迈。
楚楚有致	chu'chu'you'zhi	形容陈列整齐，富有情趣。
楚楚作态	chu'chu'zuo'tai	又作：矫揉造作。
楚得楚弓	chu'de'chu'gong	见“楚弓楚得”。
楚歌四合	chu'ge'si'he	比喻四面被围，陷入孤立危急的困境。
楚歌四面	chu'ge'si'mian	见“楚歌四合”。
楚歌四起	chu'ge'si'qi	见“楚歌四合”。
楚歌之计	chu'ge'zhi'ji	《汉书·高帝纪下》：“扞刘邦呴围羽垓下。羽夜闻汉军四面皆楚歌，知尽得楚地，羽与数百骑走，是以兵大败。”后因用“楚歌之计”谓攻心之术。
楚弓楚得	chu'gong'chu'de	亦作“楚得楚弓”。《公孙龙子·迹府》：“龙闻楚王张繁弱之弓，载忘归之矢，以射蛟、兕於云梦之圃，而丧其弓。左右请求之，王曰：‘止。楚王遗弓，楚人得之，又何求乎？’”《孔子家语·好生》、《孔丛子·公孙龙》、汉刘向《说苑·至公》等亦记有此事。后因以“楚弓楚得”或“楚得楚弓”比喻虽有所失而利未外溢。
楚弓复得	chu'gong'fu'de	喻失物复得。
楚弓遗影	chu'gong'yi'ying	《晋书·乐广传》：“尝有亲客，久阔不复来，广问其故，答曰：‘前在坐，蒙赐酒，方欲饮，见杯中有蛇，意甚恶之，既饮而疾。’于时河南听事壁上有角，漆画作蛇，广意杯中蛇即角影也。复置酒於前处，谓客曰：‘酒中复有所见不？’答曰：‘所见如初。’广乃告其所以，客豁然意解，沈痾顿愈。”后因以“楚弓遗影”比喻因某事造成的疑惧心理。
楚馆秦楼	chu'guan'qin'lou	楚灵王筑章华宫，选美人细腰者居之，人称楚馆；秦穆公女弄玉善吹箫，穆公为筑重楼以居之，名曰凤楼，后世称秦楼。后因以“楚馆秦楼”称歌榭妓院。
楚管蛮弦	chu'guan'man'xian	泛指南方的管弦乐器。
楚囊之情	chu'nang'zhi'qing	《左传·襄公十四年》：“楚子囊还自伐吴，卒。将死，遗言谓子庚：‘必城郢！’君子谓子囊忠……将死，不忘卫社稷，可不谓忠乎！”后因以“楚囊之情”谓爱国之情。
楚囚对泣	chu'qiu'dui'qi	见“楚囚相对”。
楚囚相对	chu'qiu'xiang'dui	南朝宋刘义庆《世说新语·言语》：“过江诸人，每至美日，辄相邀新亭，藉卉饮宴。周侯（周顗）中坐而叹曰：‘风景不殊，正自有山河之异！’皆相视流泪。唯王丞相（王导）愀然变色曰：‘当共戮力王室，克复神州，何至作楚囚相对！’”后用以形容人们遭遇国难或其它变故，相对无策，徒然悲伤。
楚天云雨	chu'tian'yun'yu	战国楚宋玉《高唐赋》写楚王在阳台梦见巫山神女，女去而辞曰：“妾在巫山之阳，高丘之阻，旦为朝云，暮为行雨。”后因以“楚天云雨”指巫山神女，或男女欢情。
楚尾吴头	chu'wei'wu'tou	古豫章一带位于楚地下游，吴地上游，如首尾相衔接，故称“楚尾吴头”。亦泛指长江中下游一带地方。
楚舞吴歌	chu'wu'wu'ge	泛指江南的轻歌曼舞。
楚腰蛴领	chu'yao'qi'ling	谓腰肢纤细，颈项洁白如蝤蛴。形容女子体态之美。
楚腰卫鬓	chu'yao'wei'bin	谓细腰秀发。借指美女。
楚雨巫云	chu'yu'wu'yun	楚地巫峡的云和雨。多比喻男女幽情。
楚越之急	chu'yue'zhi'ji	春秋时楚越两国先后遭吴入侵，后因以“楚越之急”泛指面临外敌入侵，国事危急。
楚云湘雨	chu'yun'xiang'yu	比喻男女幽情。
礎润而雨	chu'run'er'yu	柱下石湿润，预示天将下雨。比喻从小地方可观察出大道理，或从事物的变化迹象可以预测到事物的发展。语出宋邵伯温伪托苏洵所作《辨奸论》：“事有必至，理有固然。惟天下之静者，乃能见微而知著。月晕而风，礎润而雨，人人知之。”参阅清李绂《穆堂初稿》卷四五《书〈辨奸论〉后二则》。
处安思危	chu'an'si'wei	又作：居安思危。处在安乐的环境中，要想到可能会出现困难及危险。
处堂燕雀	chu'tang'yan'que	见“处堂燕鹊”。
处堂燕鹊	chu'tang'yan'que	《艺文类聚》卷九二引《吕氏春秋》：“燕雀处一屋之下，子母相哺，喣喣然其相乐也，自以为安矣。灶突决，火上，栋宇将焚，燕雀颜色不变，不知祸将及也。”因以“处堂燕鹊”比喻居安忘危的人。
处心积虑	chu'xin'ji'lv	谓蓄意已久。
处之绰然	chu'zhi'chuo'ran	谓处于险促的境地而显得宽绰坦然。
处之泰然	chu'zhi'tai'ran	①形容对待困难或紧急情况沉着镇定的样子。②指对某件事情毫不关心。
处之晏然	chu'zhi'yan'ran	同“处之泰然”。
处之夷然	chu'zhi'yi'ran	同“处之泰然”。
处之怡然	chu'zhi'yi'ran	同“处之泰然”。
怵目惊心	chu'mu'jing'xin	又作：触目惊心。
触处机来	chu'chu'ji'lai	谓触及某一事物而生出机悟。
触地号天	chu'di'hao'tian	呼天抢地。形容悲痛之极。
触斗蛮争	chu'dou'man'zheng	触和蛮。《庄子》寓言中蜗牛角上两个小国。见《庄子·则阳》。后因以“触斗蛮争”喻为私利而争斗。
触景伤怀	chu'jing'shang'huai	见“触景伤情”。
触景伤情	chu'jing'shang'qing	看到眼前景象而引起伤感之情。
触景伤心	chu'jing'shang'xin	见“触景伤情”。
触景生情	chu'jing'sheng'qing	看到眼前景象因而产生某种感情。
触类而长	chu'lei'er'chang	语本《易·系辞上》：“引而伸之，触类而长之，天下之能事毕矣。”孔颖达疏：“谓触逢事类而增长之。”意谓掌握一类事物知识或规律，就能据此而增长同类事物知识。
触类而通	chu'lei'er'tong	见“触类旁通”。
触类旁通	chu'lei'pang'tong	《易·系辞上》：“引而伸之，触类而长之。”又《乾》：“六爻发挥，旁通情也。”后以“触类旁通”谓掌握了某一事物规律，就能推知同类事物。
触目崩心	chu'mu'beng'xin	看到某种情况而心中极度悲伤。
触目皆是	chu'mu'jie'shi	眼睛所见到的都是某类事物。形容为数众多。
触目经心	chu'mu'jing'xin	见到而萦烦于心。
触目惊心	chu'mu'jing'xin	看到某种情况而内心震惊。形容事态严重，引起震动。
触目儆心	chu'mu'jing'xin	看到某种情况而引为儆戒。
触目警心	chu'mu'jing'xin	看到某种情况，心中引起警觉。
触目伤怀	chu'mu'shang'huai	见“触目伤心”。
触目伤心	chu'mu'shang'xin	看到某种情况而内心伤悲。
触目恸心	chu'mu'tong'xin	看到某种情况而极度悲哀。
触石决木	chu'shi'jue'mu	比喻莽撞蛮干。
触手生春	chu'shou'sheng'chun	一动手就转成了春天，富有生机。形容技术高明神奇。
黜昏启圣	chu'hun'qi'sheng	贬退昏庸，开启圣明。
黜奢崇俭	chu'she'chong'jian	革除奢华，崇尚俭仆。
黜邪崇正	chu'xie'chong'zheng	斥退奸邪，崇尚正直。
黜衣缩食	chu'yi'suo'shi	节衣缩食。指在生活上省穿省吃，力求节约。
黜幽陟明	chu'you'zhi'ming	见“黜陟幽明”。
黜陟幽明	chu'zhi'you'ming	黜退昏愚的官员，晋升贤明的官员。
揣骨听声	chuai'gu'ting'sheng	原指旧时相法之一种。不相其面，而摸其骨骼，听其语声，以判贵贱。后以喻牵强附会，妄加评判。
揣时度力	chuai'shi'du'li	忖度形势，估量自己的能力。
啜菽饮水	chuo'shu'yin'shui	亦省作“啜菽”。①吃豆类，喝清水。语出《礼记·檀弓下》：“子路曰：‘伤哉贫也！生无以为养，死无以为礼也。’子曰：‘啜菽饮水，尽其欢，斯之谓孝。’”后因以为贫家孝子事亲之典。②指生活清苦。
啜英咀华	chuo'ying'ju'hua	比喻品赏、体味诗文的精华。语出唐韩愈《进学解》：“沉浸醲郁，含英咀华。”
川流不息	chuan'liu'bu'xi	谓河水流动不停。亦形容事物象水流一样连续不断。
川渟岳峙	chuan'ting'yue'zhi	谓水止不流，山高矗立。比喻人的凝重庄严。川，本作“渊”，因避唐高祖李渊讳改。
穿房入户	chuan'fang'ru'hu	随意进出别人的房间。形容偷盗或熟悉门户。
穿红着绿	chuan'hong'zhuo'lv	形容衣着鲜艳华丽。
穿花蛱蝶	chuan'hua'jia'die	穿戏花丛中的蝴蝶。唐杜甫《曲江》诗之二：“穿花蛱蝶深深见，点水蜻蜓款款飞。”后以喻迷恋女色者。
穿荆度棘	chuan'jing'du'ji	穿越荆棘丛生处。喻多经艰难路途。
穿文凿句	chuan'wen'zao'ju	钻研文字，琢磨词句。《艺文类聚》卷七九引南朝宋刘义庆《幽明录》：“君年少，何以轻穿文凿句，而妄讥诮老子耶？”后用作为文牵强附会之意。
穿宵连夜	chuan'xiao'lian'ye	通宵。
穿穴逾墙	chuan'xue'yu'qiang	指偷窃行为。
穿杨贯虱	chuan'yang'guan'shi	战国时养由基射箭能百步穿杨，纪昌射箭能正中虱心。事见《战国策·西周策》和《列子·汤问》。后因以“穿杨贯虱”形容技艺高超。
穿云裂石	chuan'yun'lie'shi	穿入云层，震裂石塊。极言声音之激越。
穿凿附会	chuan'zao'fu'hui	生拉硬扯，牵强解释。
穿凿傅会	chuan'zao'fu'hui	见“穿凿附会”。
穿针引线	chuan'zhen'yin'xian	亦作“穿针引线”。比喻从中牵线撮合。
穿针引线	chuan'zhen'yin'xian	见“穿针引线”。
传杯换盏	chuan'bei'huan'zhan	同“传杯弄盏”。
传杯弄盏	chuan'bei'nong'zhan	谓酒宴中互相斟酒。
传柄移藉	chuan'bing'yi'jie	谓权势转移。
传风搧火	chuan'feng'shan'huo	犹煽风点火。比喻鼓动别人做某种事。多用于贬义。
传圭袭组	chuan'gui'xi'zu	谓取得功名。圭，古代帝王、诸侯举行隆重仪式时所用的玉制礼器；组，古代官员系印的丝带，转指官印。
传宗接代	chuan'zong'jie'dai	继承祖业，延续后代。
传@袭紫	chuan'@'xi'zi	谓继承高爵显位。汉制，公侯皆佩紫绶龟纽金印。
船到江心补漏迟	chuan'dao'jiang'xin'bu'lou'chi	迟】	比喻事先无准备，临时张皇失措。
船到桥门自然直	chuan'dao'qiao'men'zi'ran'zhi	直】	意谓事先不用着急，到时候问题总可以解决。这是在无可奈何中强作宽慰的说法。
船到桥头自会直	chuan'dao'qiao'tou'zi'hui'zhi	直】	见“船到桥门自然直”
喘月吴牛	chuan'yue'wu'niu	相传吴地之牛畏热，见月亦疑为日，喘息不已。见南朝宋刘义庆《世说新语·言语》。后因以为典实。亦比喻因受某事物之苦而畏惧其类似者。
疮好忘痛	chuang'hao'wang'tong	又作：好了伤疤忘了痛。
疮疥之疾	chuang'jie'zhi'ji	喻轻微的祸患。
疮巨釁深	chuang'ju'xin'shen	犹创巨痛深。
疮痍满目	chuang'yi'man'mu	形容遭到严重破坏或灾害后的景象。
疮痍弥目	chuang'yi'mi'mu	见“疮痍满目”。
窗间过马	chuang'jian'guo'ma	形容时间过得很快。
窗明几净	chuang'ming'ji'jing	明亮的窗户，洁净的小桌子。形容环境清洁。
床上安床	chuang'shang'an'chuang	同“床上施床”。见“床上施床”。
床上叠床	chuang'shang'die'chuang	同“床上施床”。
床上施床	chuang'shang'shi'chuang	喻无谓的重复。
床上施床	chuang'shang'shi'chuang	喻无谓之重复。
床上施床	chuang'shang'shi'chuang	喻无谓之重复。
床头金尽	chuang'tou'jin'jin	谓身边钱财耗尽，陷于贫困境地。语出唐张籍《行路难》诗：“君不见床头黄金尽，壮士无颜色。”
床头金尽	chuang'tou'jin'jin	谓钱财耗尽。
床头金尽	chuang'tou'jin'jin	谓钱财耗尽。
创巨痛仍	chuang'ju'tong'reng	亦作“创钜痛仍”。谓创伤深重而悲痛长久。
创巨痛深	chuang'ju'tong'shen	语本《礼记·三年问》：“创钜者其日久，痛甚者其愈迟。”《荀子·礼论》钜作“巨”，愈作“瘉”。后以“创巨痛深”谓创伤重，痛苦深。
创钜痛仍	chuang'ju'tong'reng	见“创巨痛仍”。
创钜痛仍	chuang'ju'tong'reng	见“创巨痛仍”。
创剧痛深	chuang'ju'tong'shen	谓创伤大、痛苦深。
创业垂统	chuang'ye'chui'tong	开创基业，传之子孙。
创意造言	chuang'yi'zao'yan	犹立意遣词。
吹灯拔蜡	chui'deng'ba'la	比喻垮台；散伙。
吹垢索瘢	chui'gou'suo'ban	又作：吹毛求疵。
吹花嚼蕊	chui'hua'jiao'rui	见“吹叶嚼蕊”。
吹灰之力	chui'hui'zhi'li	比喻用力极小。
吹糠见米	chui'kang'jian'mi	比喻收效快。
吹毛求疵	chui'mao'qiu'ci	①吹开皮上的毛，寻找里面的毛病。比喻刻意挑剔过失或缺点。语出《韩非子·大体》：“古之全大体者……不吹毛而求小疵，不洗垢而察难知。”②谓指摘细小的毛病。
吹毛求瑕	chui'mao'qiu'xia	同“吹毛求疵”。
吹毛数睫	chui'mao'shu'jie	比喻目光短浅，只注意微末细节。
吹毛索瘢	chui'mao'suo'ban	同“吹毛求疵”。
吹毛索疵	chui'mao'suo'ci	同“吹毛求疵”。
吹毛索垢	chui'mao'suo'gou	同“吹毛求疵”。
吹毛洗垢	chui'mao'xi'gou	吹开皮上的毛而洗去所藏的污垢。比喻一意寻找他人的过失或缺点。
吹牛拍马	chui'niu'pai'ma	吹嘘奉承。
吹气如兰	chui'qi'ru'lan	见“吹气胜兰”。
吹气胜兰	chui'qi'sheng'lan	①谓美女气息之香胜于兰花。②形容文词华美。
吹网欲满	chui'wang'yu'man	对网吹气，欲使之满。比喻不可能。
吹叶嚼蕊	chui'ye'jiao'rui	①谓吹奏、歌唱。②引申指反复推敲声律、词藻。
吹影镂尘	chui'ying'lou'chen	喻不见形迹。
吹竹弹丝	chui'zhu'dan'si	吹奏管乐器，弹拨弦乐器。
炊金馔玉	chui'jin'zhuan'yu	比喻饮食珍贵，生活极其奢华。
炊粱跨卫	chui'liang'kua'wei	用高粱做饭，骑驴子代步。形容简朴的生活。卫，驴的别名。
炊琼爇桂	chui'qiong'ruo'gui	煮玉烧桂。比喻物价高昂。
炊沙镂冰	chui'sha'lou'bing	炊沙不能成饭，刻冰不能作器。比喻徒劳无功。
炊沙作饭	chui'sha'zuo'fan	煮沙子作饭。喻徒劳无功，白费气力。
炊沙作糜	chui'sha'zuo'mi	同“炊沙作饭”。
炊砂作饭	chui'sha'zuo'fan	见“炊沙作饭”。
炊鲜漉清	chui'xian'lu'qing	煮鱼滤酒。
垂耳下首	chui'er'xia'shou	犹俯首帖耳，形容驯服听命。
垂饵虎口	chui'er'hu'kou	往虎口送食。比喻置身险地。
垂帘听决	chui'lian'ting'jue	见“垂帘听政”。
垂帘听政	chui'lian'ting'zheng	谓女后辅幼主临朝听政。
垂首丧气	chui'shou'sang'qi	同“垂头丧气”。
垂死挣扎	chui'si'zheng'za	形容最后的反抗。多含贬义。
垂头塞耳	chui'tou'sai'er	谓不问不闻，装聋作哑。
垂头丧气	chui'tou'sang'qi	①形容失望懊丧的样子。②形容禾苗枯萎，没有生气。
垂头铩羽	chui'tou'sha'yu	亦作“垂头搨翼”。
垂头塌翅	chui'tou'ta'chi	见“垂头搨翼”。
垂头搨翼	chui'tou'ta'yi	亦作“垂头塌翅”。形容受挫后萎靡不振的样子。
垂涎三尺	chui'xian'san'chi	嘴边挂着三尺长的口水。形容嘴馋到极点。亦形容羡慕到极点，极想据为己有。
垂涎欲滴	chui'xian'yu'di	语本唐柳宗元《招海贾文》：“垂涎闪舌兮，挥霍旁午。”后以“垂涎欲滴”谓嘴馋得口水快要流下来。形容贪馋到极点。
捶骨沥髓	chui'gu'li'sui	同“敲骨吸髓”。喻残酷搜括民财。
捶胸跌脚	chui'xiong'die'jiao	表示极为悲伤或悲愤。
捶胸顿脚	chui'xiong'dun'jiao	见“捶胸跌脚”。
捶胸顿足	chui'xiong'dun'zu	见“捶胸跌脚”。
搥胸跌脚	chui'xiong'die'jiao	悲极貌。
搥胸跌足	chui'xiong'die'zu	见“搥胸跌脚”。
槌牛酾酒	chui'niu'shi'jiu	杀牛滤酒。谓备肴酒以燕享。
槌仁提义	chui'ren'ti'yi	抛弃仁义。
槌胸蹋地	chui'xiong'ta'di	捶胸顿足。表示极度悲痛或悔恨。
春风得意	chun'feng'de'yi	①在春风轻拂中洋洋自得。旧指读书人考中后的得意心情。②形容官运亨通或事情办成功，达到目的时得意洋洋的情态。
春风风人	chun'feng'feng'ren	和煦的春风吹拂着人们。比喻予人以教益和帮助。
春风和气	chun'feng'he'qi	形容温和融乐的气氛或和善的态度。
春风化雨	chun'feng'hua'yu	①《孟子·尽心上》：“有如时雨化之者。”汉刘向《说苑·贵德》：“吾不能以春风风人，吾不能以夏雨雨人，吾穷必矣。”后遂以“春风化雨”比喻良好教育的普及与深入。②喻适宜的环境和条件。
春风野火	chun'feng'ye'huo	比喻迅猛之势。
春风一度	chun'feng'yi'du	比喻领略一番意境或情趣。多指男女间的欢爱。
春花秋实	chun'hua'qiu'shi	见“春华秋实”。
春花秋月	chun'hua'qiu'yue	①春天的花，秋天的月。指春秋佳景或泛指美好的时光。②指岁序更迭。
春华秋实	chun'hua'qiu'shi	亦作“春花秋实”。①春天开花，秋天结果。②喻文采和品行学问，或事物的因果关系。
春兰秋菊	chun'lan'qiu'ju	春天的兰花和秋天的菊花。多比喻物擅其长，各具其美。
春秋笔法	chun'qiu'bi'fa	《春秋》，鲁国史书。相传为孔子所修。经学家认为它每用一字，必寓褒贬，后因以称曲折而意含褒贬的文字为“春秋笔法”。
春蛇秋蚓	chun'she'qiu'yin	见“春蚓秋蛇”。
春树暮云	chun'shu'mu'yun	唐杜甫《春日忆李白》诗：“渭北春天树，江东日暮云。”诗借云树而写思念之情。后遂以“春树暮云”为仰慕、怀念友人之辞。
春诵夏弦	chun'song'xia'xian	亦作“春诵夏弦”。《礼记·文王世子》：“春诵夏弦，大师诏之”。郑玄注：“诵，谓歌乐也；弦，谓以丝播诗”。本谓应按季节而采用不同的学习方式，后亦以泛指学习咏诵。
春诵夏弦	chun'song'xia'xian	见“春诵夏弦”。
春蚓秋蛇	chun'yin'qiu'she	喻书法拙劣，婉曲无状。语出《晋书·王羲之传论》：“扞萧子云呴仅得成书，无丈夫之气，行行若萦春蚓，字字如绾秋蛇”。
椿庭萱室	chun'ting'xuan'shi	指父母。
莼羹鲈脍	chun'geng'lu'kuai	《晋书·文苑传·张翰》：“翰因见秋风起，乃思吴中菰菜、莼羹、鲈鱼脍，曰：‘人生贵得適志，何能羁宦数千里以要名爵乎！’遂命驾而归。”后因以“莼羹鲈脍”用为思乡辞官的典故。
脣敝舌腐	chun'bi'she'fu	犹脣焦舌敝。
脣齿相须	chun'chi'xiang'xu	犹脣齿相依。
脣齿相依	chun'chi'xiang'yi	比喻关系密切，互相依存。
脣齿相依	chun'chi'xiang'yi	比喻关系密切，互相依靠。
脣齿相依	chun'chi'xiang'yi	比喻关系密切，互相依靠。
脣辅相连	chun'fu'xiang'lian	又作：脣齿相依。语本《左传·僖公五年》：“辅车相依，脣亡齿寒。”
脣腐齿落	chun'fu'chi'luo	比喻读书讽诵极为勤苦。
脣尖舌利	chun'jian'she'li	言词尖利。
脣焦口燥	chun'jiao'kou'zao	犹口干舌燥。形容费尽口舌。
脣焦口燥	chun'jiao'kou'zao	口脣干燥。形容费尽口舌以致疲倦。
脣焦口燥	chun'jiao'kou'zao	口脣干燥。形容费尽口舌以致疲倦。
脣焦舌敝	chun'jiao'she'bi	嘴干舌破。形容说话甚多、反复陈述而极度疲劳。语本汉赵晔《吴越春秋·夫差内传》：“焦脣乾舌，苦身劳力，上事群臣，下养百姓。”
脣焦舌敝	chun'jiao'she'bi	嘴干舌破。形容说话甚多、反复陈述而极度疲劳。语本汉赵晔《吴越春秋·夫差内传》：“焦脣乾舌，苦身劳力，上事群臣，下养百姓。”
脣焦舌敝	chun'jiao'she'bi	犹口干舌燥。形容费尽脣舌。
脣揭齿寒	chun'jie'chi'han	见“脣亡齿寒”。
脣竭齿寒	chun'jie'chi'han	见“脣亡齿寒”。
脣枪舌剑	chun'qiang'she'jian	形容言辞锋利，争辩激烈。
脣枪舌剑	chun'qiang'she'jian	脣如枪，舌似剑。形容辩论激烈，言词锋利。
脣枪舌剑	chun'qiang'she'jian	脣如枪，舌似剑。形容辩论激烈，言词锋利。
脣鎗舌剑	chun'qiang'she'jian	见“脣枪舌剑”。
脣亡齿寒	chun'wang'chi'han	脣缺则齿露受冷。比喻关系密切，利害相关。语本《左传·僖公五年》：“晋侯复假道於虞以伐虢。宫之奇谏曰：虢，虞之表也；虢亡，虞必从之……谚所谓‘辅车相依，脣亡齿寒’者，其虞虢之谓也。”
脣亡齿寒	chun'wang'chi'han	嘴脣失去，牙齿即要寒冷。比喻互为依存，利害相关。
脣亡齿寒	chun'wang'chi'han	嘴脣失去，牙齿即要寒冷。比喻互为依存，利害相关。
鹑居鷇食	chun'ju'kou'shi	比喻生活简约。语出《庄子·天地》：“夫圣人鹑居而鷇食。”成玄英疏：“鹑，л鹑也，野居无常处。鷇者，鸟之子，食必仰母而足。圣人寝处俭薄，譬彼л鹑；供膳裁充，方兹鷇鸟。既无心於侈靡，岂有情於滋味乎？”
鹑居鷇饮	chun'ju'kou'yin	同“鹑居鷇食”。
鹑衣百结	chun'yi'bai'jie	形容衣服破烂不堪。
鹑衣鹄面	chun'yi'hu'mian	破烂的衣服，瘦削的面形。形容穷苦落魄之状。
鹑衣鷇食	chun'yi'kou'shi	谓衣不蔽体，食不果腹。形容生活极端贫困。
醇酒妇人	chun'jiu'fu'ren	《史记·魏公子列传》：“公子自知再以毁废，乃谢病不朝，与宾客为长夜饮，饮醇酒，多近妇女。日夜为乐饮者四岁，竟病酒而卒。”后以“醇酒妇人”指酒色。
醇酒美人	chun'jiu'mei'ren	指酒色。
蠢蠢思动	chun'chun'si'dong	同“蠢蠢欲动”。
蠢蠢欲动	chun'chun'yu'dong	①像虫豸一样蠕蠕爬动。②谓准备扰动为乱。
蠢动含灵	chun'dong'han'ling	又作：一切众生。
踔厉奋发	chuo'li'fen'fa	见“踔厉风发”。
踔厉风发	chuo'li'feng'fa	①形容雄辩恣肆；议论纵横。②形容精神振奋；斗志昂扬。
踔厉骏发	chuo'li'jun'fa	见“踔厉风发”。
戳无路兒	chuo'wu'lu'er	捣鬼，无中生有的挑拨。
戳心灌髓	chuo'xin'guan'sui	刺心并深入骨髓。形容刻毒得使人忍不住。
绰绰有馀	chuo'chuo'you'yu	同“绰有馀裕”。
绰绰有裕	chuo'chuo'you'yu	同“绰有馀裕”。
绰然有馀	chuo'ran'you'yu	同“绰有馀裕”。形容宽裕、富馀。
绰有馀暇	chuo'you'yu'xia	同“绰有馀裕”。形容态度从容。
绰有馀裕	chuo'you'yu'yu	①《孟子·公孙丑下》：“我无官守，我无言责也，则吾进退岂不绰绰然有馀裕哉？”赵歧注：“进退自由，岂不绰绰然舒缓有馀裕乎？绰、裕，皆宽也。”后因以“绰有馀裕”形容态度从容、不慌不忙。②用以形容宽裕、富馀。
逴俗绝物	chuo'su'jue'wu	又作：超世绝俗。
辍毫栖牍	chuo'hao'qi'du	停笔藏牍，谓停止写作。牍，古代写字用的狭长木板。
歠菽饮水	chuo'shu'yin'shui	喝豆粥饮白水。喻生活清苦。
呲牙咧嘴	zi'ya'lie'zui	①露出牙齿，咧开嘴巴。②形容相貌凶狠或样子难看。③形容难以忍受的怪模样。
呲牙咧嘴	zi'ya'lie'zui	呲牙咧嘴。形容痛苦之状。
词不达意	ci'bu'da'yi	谓词句不能充分、确切地表达思想感情。
词不逮意	ci'bu'dai'yi	又作：词不达意。
词华典赡	ci'hua'dian'shan	文词华丽，用典周备。
词清讼简	ci'qing'song'jian	词讼清简。谓狱讼稀少，政事清闲。
词穷理尽	ci'qiong'li'jin	谓再也找不到理由，无话可说。
词穷理绝	ci'qiong'li'jue	同“词穷理尽”。
词穷理屈	ci'qiong'li'qu	谓理由亏屈，无话可说。
词严义密	ci'yan'yi'mi	措词严谨，道理周密。
词严义正	ci'yan'yi'zheng	措词严肃，道理正当。
词约指明	ci'yue'zhi'ming	言词简洁，旨意明确。
词正理直	ci'zheng'li'zhi	言词严正，理由充足。
慈明无双	ci'ming'wu'shuang	《后汉书·荀爽传》：“爽字慈明，一名谞。幼而好学，年十二，能通《春秋》、《论语》。太尉杜乔见而称之，曰：‘可为人师。’爽遂耽思经书，庆吊不行，徵命不应。颍川为之语曰：‘荀氏八龙，慈明无双。’”后因以“慈明无双”赞扬兄弟或平辈中之最负声望者。
辞不达义	ci'bu'da'yi	说话写文章不能确切地表达意思。语本《仪礼·聘礼》：“辞多则史，少则不达，辞苟足以达义之至也。”
辞不达意	ci'bu'da'yi	见“辞不达义”。
辞不获命	ci'bu'huo'ming	谓辞谢而未获允许。
辞简义赅	ci'jian'yi'gai	文辞简要，意义完备。
辞金蹈海	ci'jin'dao'hai	战国时，秦军围赵都邯郸，齐人鲁仲连以利害进说赵魏大臣，劝阻尊秦昭王为帝，并表示若秦王为帝，则自己将蹈东海而死。秦军退后，赵平原君以千金谢之，鲁仲连却不受，以为为人排难解纷而取酬，是商贾之事。见《史记·鲁仲连邹阳列传》。后以“辞金蹈海”比喻不慕富贵，慷慨有气节。
辞穷理屈	ci'qiong'li'qu	理由站不住脚，被驳得无话可说。
辞严气正	ci'yan'qi'zheng	又作：辞严义正。
辞严义正	ci'yan'yi'zheng	措辞严肃，道理正当。
辞严谊正	ci'yan'yi'zheng	同“辞严义正”。
辞严意正	ci'yan'yi'zheng	同“辞严义正”。
此唱彼和	ci'chang'bi'he	这个唱，那个和。多指写诗、作文或说话的互相呼应。
此处不留人，会有留人处	ci'chu'bu'liu'ren'-'hui'you'liu'ren'chu	会有留人处】	见“此处不留人，自有留人处”。
此处不留人，自有留人处	ci'chu'bu'liu'ren'-'zi'you'liu'ren'chu	自有留人处】	谓这里不可居留，自会有可居留的地方。
此地无银三百两	ci'di'wu'yin'san'bai'liang	两】	民间故事：有人把银子埋藏地下，上面留字写道：“此地无银三百两”。邻人阿二偷走了银子，也留字写道：“隔壁阿二不曾偷”。后用以比喻想要掩盖事实，反而更加暴露。
此动彼应	ci'dong'bi'ying	见“此发彼应”。
此而可忍，孰不可忍	ci'er'ke'ren'-'shu'bu'ke'ren	不可忍】	这个如能容忍，还有什么不能容忍呢！
此发彼应	ci'fa'bi'ying	这里发动，那里响应。
此伏彼起	ci'fu'bi'qi	同“此起彼伏”。
此疆尔界	ci'jiang'er'jie	谓划分疆界，彼此阻隔。
此界彼疆	ci'jie'bi'jiang	见“此疆尔界”。
此起彼伏	ci'qi'bi'fu	这里起来，那里落下。表示连续不断。
此起彼落	ci'qi'bi'luo	同“此起彼伏”。
此问彼难	ci'wen'bi'nan	这个诘问，那个责难。
此一时彼一时	ci'yi'shi'bi'yi'shi	】	语本《孟子·公孙丑下》：“彼一时，此一时也。五百年必有王者兴，其间必有名世者”。谓时间不同，情况亦异，不能相提并论。
刺刺不休	ci'ci'bu'xiu	多言貌。语出唐韩愈《送殷员外序》：“出门惘惘，有离别可怜之色。持被入直三省，丁宁顾婢子，语刺刺不能休。”清蒲松龄《聊斋志异·口技》：“三人絮语间杂，刺刺不休。”
刺虎持鹬	ci'hu'chi'yu	喻待机行事，一举两得。
刺上化下	ci'shang'hua'xia	讽谕国君，教化下民。
刺心刻骨	ci'xin'ke'gu	①谓感念至深。②亦作“刺心切骨”。内心极其悲愤。
刺心裂肝	ci'xin'lie'gan	谓悲痛至极。
刺心切骨	ci'xin'qie'gu	见“刺心刻骨”。
赐茅授土	ci'mao'shou'tu	封建社会帝王分封诸侯的一种礼仪。帝王以五色土为太社，分封诸侯时，各授以他们相应的某方某色土，如东方青土，南方赤土等，并包以白茅，使归以立社。
赐墙及肩	ci'qiang'ji'jian	语出《论语·子张》：“叔孙武叔语大夫于朝曰：‘子贡贤于仲尼。’子服景伯以告子贡，子贡曰：‘譬之宫墙，赐之墙也及肩，窥见室家之好。夫子之墙数仞，不得其门而入，不见宗庙之美，百官之富。’”后因以“赐墙及肩”喻才学浅露。
从长计较	cong'chang'ji'jiao	又作：从长计议。
从长计议	cong'chang'ji'yi	《左传·僖公四年》：“卜人曰：‘筮短@长，不如从长。’”本指从长而定。后以“从长计议”指不急于作出决定，或慢慢地设法解决。
从长商议	cong'chang'shang'yi	又作：从长计议。
从恶如崩	cong'e'ru'beng	亦作“从恶若崩”。谓为恶如山崩那样容易。
从恶若崩	cong'e'ruo'beng	见“从恶如崩”。
从风而靡	cong'feng'er'mi	①谓如风之吹草，草随风倾倒。比喻强弱悬殊，弱者不堪一击，即告瓦解。②谓如风之吹草，草随风倾倒。比喻仿效、风行之迅速。
从谏如流	cong'jian'ru'liu	谓听从善意的规劝，就象水从高处流下一样顺暢。形容乐意接受别人意见。多用于帝王。
从井救人	cong'jing'jiu'ren	语本《论语·雍也》：“仁者，虽告之曰：‘井有仁（仁人）焉。’其从之也？”意谓跟着跳到井里去救人。原用以比喻对别人并无好处而徒然危害自己的行为。后亦用以比喻冒极大危险去拯救别人。
从令如流	cong'ling'ru'liu	谓服从命令如流水就下。极言有令则行。
从流忘反	cong'liu'wang'fan	谓习从流俗而不可扭转。
从容不迫	cong'rong'bu'po	不慌不忙，沉着镇静。
从容就义	cong'rong'jiu'yi	非常镇静、毫无畏惧地为正义而死。
从容自如	cong'rong'zi'ru	不慌不忙，得心应手。
从容自若	cong'rong'zi'ruo	沉着镇静，神态如常。
从善如登	cong'shan'ru'deng	谓为善如登山那样不易。
从善如流	cong'shan'ru'liu	亦作“从善若流”。听从正确的意见如水之从高处流下那样地迅速和顺当。
从善若流	cong'shan'ruo'liu	见“从善如流”。
从天而降	cong'tian'er'jiang	见“从天而下”。
从天而下	cong'tian'er'xia	比喻意想不到，突如其来。偶亦指好事之遽降。
从头彻尾	cong'tou'che'wei	自始至终。
从头到尾	cong'tou'dao'wei	见“从头至尾”。
从头至尾	cong'tou'zhi'wei	亦作“从头到尾”。①自始至终。指全过程。②从头到脚。指全身。
从心所欲	cong'xin'suo'yu	①随自己心意，想怎样就怎样。②代指七十岁。
从一而终	cong'yi'er'zhong	①谓一女不事二夫，夫死不得再嫁。②比喻忠臣不事二主。
聪明才智	cong'ming'cai'zhi	指智慧和才能。
聪明伶俐	cong'ming'ling'li	聪慧灵活。
聪明睿知	cong'ming'rui'zhi	见“聪明睿智”。
聪明睿智	cong'ming'rui'zhi	亦作“聪明叡知”。亦作“聪明睿知”。聪颖明智。
聪明叡知	cong'ming'rui'zhi	见“聪明睿智”。
聪明自误	cong'ming'zi'wu	见“聪明反被聪明误”。
丛轻折轴	cong'qing'zhe'zhou	谓即使轻而小的物件，装载多了也可以使车轴折断。
丛雀渊鱼	cong'que'yuan'yu	比喻不行善政，等于把老百姓趕到敌人方面去。语本《孟子·离娄上》：“为渊驱鱼者，獭也；为丛驱爵（雀）者，鹯也；为汤武驱民者，桀与纣也。”
丛山峻岭	cong'shan'jun'ling	无数高大险峻的山岭。
粗茶淡饭	cu'cha'dan'fan	简单的饮食。形容生活简约。
粗风暴雨	cu'feng'bao'yu	①犹暴风骤雨。谓风雨之来势急骤狂猛。②比喻猛烈的声势。
粗服乱头	cu'fu'luan'tou	粗劣的衣服，蓬乱的头发。谓不加修饰。
粗服乱头	cu'fu'luan'tou	粗劣的衣服，蓬乱的头发。谓不加修饰。
粗袍粝食	cu'pao'li'shi	同“粗衣恶食”。
粗心大意	cu'xin'da'yi	对待事物马虎草率，不认真，不细心。
粗心浮气	cu'xin'fu'qi	不细致；不沉着。
粗心浮气	cu'xin'fu'qi	谓办事浮躁，不细心。
粗衣淡饭	cu'yi'dan'fan	粗布衣服，平常饭食。形容生活俭朴。
粗衣恶食	cu'yi'e'shi	粗劣的衣食。常形容生活清苦。
粗衣粝食	cu'yi'li'shi	粗劣的衣食。形容生活清苦。
粗枝大叶	cu'zhi'da'ye	亦作“粗株大叶”。①形容简略概括。②形容粗疏，不精细。
粗枝大叶	cu'zhi'da'ye	谓文字或话语简略概括。
粗制滥造	cu'zhi'lan'zao	谓制造的产品不顾质量差、只求数量多。泛指工作草率马虎、不负责任。
粗中有细	cu'zhong'you'xi	表面似乎粗率，实际却很细致；平时比较粗率，有时却很细致。
粗株大叶	cu'zhu'da'ye	见“粗枝大叶”。
猝不及防	cu'bu'ji'fang	事情突然发生，来不及防备。
蹙蹙靡骋	cu'cu'mi'cheng	《诗·小雅·节南山》：“我瞻四方，蹙蹙靡所骋。”后因“蹙蹙靡骋”谓局促，无法舒展。
蹙金结绣	cu'jin'jie'xiu	形容文章精美，结构严密。
窜端匿迹	cuan'duan'ni'ji	谓藏匿事物的头绪。
篡党夺权	cuan'dang'duo'quan	篡夺党和国家的领导权。
爨桂炊玉	cuan'gui'chui'yu	谓薪如桂，米似玉。比喻物价贵昂，生活艰辛。
摧锋陷坚	cui'feng'xian'jian	又作：摧锋陷阵。
摧锋陷阵	cui'feng'xian'zhen	破敌深入。
摧坚陷阵	cui'jian'xian'zhen	犹摧锋陷阵。
摧枯拉腐	cui'ku'la'fu	见“摧枯折腐”。
摧枯拉朽	cui'ku'la'xiu	摧折枯枝朽木。比喻极容易办到。语本《汉书·异姓诸侯王表序》：“镌金石者难为功，摧枯朽者易为力，其势然也。”
摧枯折腐	cui'ku'zhe'fu	摧折枯枝腐木。比喻极容易办到。
摧枯振朽	cui'ku'zhen'xiu	犹摧枯拉朽。
摧眉折腰	cui'mei'zhe'yao	低眉弯腰。又作：卑躬屈膝。
摧陷廓清	cui'xian'kuo'qing	攻克强敌并加以扫荡。亦喻破除陈言。
摧朽拉枯	cui'xiu'la'ku	见“摧枯拉朽”。
榱崩栋折	cui'beng'dong'zhe	喻大局崩溃。
啛啛喳喳	cui'cui'zha'zha	象声词。形容杂乱细碎的说话声。
翠被豹舄	cui'bei'bao'xi	以翡翠羽为背帔，以豹皮为履。指生活奢侈。被，同“帔”。
翠尘珠坱	cui'chen'zhu'yang	谓珠翠落于尘土。比喻人才横被堙没。
翠纶桂饵，反以失鱼	cui'lun'gui'er'-'fan'yi'shi'yu	以失鱼】	《太平御览》卷八三四引《阙子》：“鲁人有好钓者，以桂为饵，黄金之钩，错以银碧，垂翡翠之纶，其持竿处位即是，然其得鱼不几矣。故曰，钓之务，不在芳饰。”后以“翠纶桂饵，反以失鱼”指华而不实者必然事与愿违。
翠绕珠围	cui'rao'zhu'wei	形容富家女子的华丽装饰。亦比喻随从侍女众多。
翠围珠裹	cui'wei'zhu'guo	见“翠绕珠围”。
翠围珠绕	cui'wei'zhu'rao	见“翠绕珠围”。
翠袖红裙	cui'xiu'hong'qun	泛指妇女的服装。亦用为妇女的代称。
翠羽明珰	cui'yu'ming'dang	见“翠羽明珠”。
翠羽明珠	cui'yu'ming'zhu	泛指珍贵的饰物。
翠竹黄花	cui'zhu'huang'hua	《景德传灯录·慧海禅师》：“迷人不知法身无象，应物现形，遂唤青青翠竹，总是法身；郁郁黄华，无非般若。黄华若是般若，般若即同无情；翠竹若是法身，法身即同草木。”后因以“翠竹黄花”指眼前境物。
村夫俗子	cun'fu'su'zi	粗俗人。
村哥里妇	cun'ge'li'fu	谓平民百姓。里，里巷。
村歌社鼓	cun'ge'she'gu	民间的歌谣、鼓乐。
村歌社舞	cun'ge'she'wu	指民间歌舞。
村生泊长	cun'sheng'bo'chang	谓生长于村野。泊，水泊。
村箫社鼓	cun'xiao'she'gu	指民间鼓乐。
村学究语	cun'xue'jiu'yu	谓迂腐浅陋的言辞。
存而不论	cun'er'bu'lun	把问题搁置起来，不加推究和讨论。
存十一於千百	cun'shi'yi'yu'qian'bai	】	谓亡多而存少。
存亡继绝	cun'wang'ji'jue	亦作“存亡续绝”。原谓使亡国复存，绝嗣得续。亦泛指使濒临灭亡或已亡者得以继续存在或延续。
存亡绝续	cun'wang'jue'xu	继续生存或者灭亡。形容势态十分危急。
存亡续绝	cun'wang'xu'jue	见“存亡继绝”。
存心积虑	cun'xin'ji'lv	谓长期、一贯的思想、想法。
寸兵尺铁	cun'bing'chi'tie	喻微小的武力。
寸步不离	cun'bu'bu'li	①一步也不离开。②形容关系亲密。
寸步难行	cun'bu'nan'xing	亦作“寸步难移”。①形容行动极为困难。②喻处境极其艰难，什么事也做不成。
寸步难移	cun'bu'nan'yi	见“寸步难行”。
寸步千里	cun'bu'qian'li	喻相见之难。
寸草不留	cun'cao'bu'liu	①连一点兒草都没留下。②形容消除净尽，什么东西都没有留存。
寸草春晖	cun'cao'chun'hui	喻子女报答不尽父母养育之恩。语本唐孟郊《游子吟》：“慈母手中线，游子身上衣。临行密密缝，意恐迟迟归。谁言寸草心，报得三春晖！”
寸草衔结	cun'cao'xian'jie	喻虽然力薄，亦当感恩图报。
寸长尺短	cun'chang'chi'duan	语出《楚辞·卜居》：“尺有所短，寸有所长。”喻人各有长处和短处。亦指微才薄技。
寸长尺技	cun'chang'chi'ji	又作：微才薄技。
寸长片善	cun'chang'pian'shan	亦作“寸善片长”。微小的长处和优点。
寸地尺天	cun'di'chi'tian	每一塊土地和天空。又作：每处。
寸积铢累	cun'ji'zhu'lei	点滴积累。
寸量铢称	cun'liang'zhu'cheng	喻极细小之事亦必计较。
寸木岑楼	cun'mu'cen'lou	语出《孟子·告子下》：“不揣其本而齐其末，方寸之木，可使高于岑楼。金重于羽者，岂谓一钩金与一舆羽之谓哉！”硃熹集注：“若不取其下之平，而升寸木於岑楼之上，则寸木反高，岑楼反卑矣。”原喻比较事物的基准不一致，就会得出错误结论。后亦用以指类比不当的错误。
寸男尺女	cun'nan'chi'nv	又作：一男半女。
寸善片长	cun'shan'pian'chang	见“寸长片善”。
寸丝不挂	cun'si'bu'gua	①佛教禅宗用以比喻心无一点挂碍。②赤身裸体。
寸蹄尺缣	cun'ti'chi'jian	喻收受小贿。蹄，“蹄”的古字，兽蹄，缣，黄色的细绢。
寸田尺宅	cun'tian'chi'zhai	①道教语。寸田谓三丹田，尺宅谓面。②指微薄的产业。
寸铁杀人	cun'tie'sha'ren	喻贵精不贵多。又作：一语中的。
寸土尺金	cun'tu'chi'jin	喻土地收益极高，极其贵重。
寸辖制轮	cun'xia'zhi'lun	喻控制事物的关键虽小而极重要。辖，固定车轮与车轴位置，插入轴端孔穴的销钉。
寸阴若岁	cun'yin'ruo'sui	时间虽短，犹觉如年。喻盼待殷切。
寸指测渊	cun'zhi'ce'yuan	以一寸之指而测深渊。喻浅学不能探明深理。语本《孔丛子·答问》：“子立尺表以度天，植寸指以测渊，蒙大道而不悟，信诬说以疑圣，殆非所望也。”
搓手顿足	cuo'shou'dun'zu	形容焦急的样子。
撮科打閧	cuo'ke'da'hong	又作：插科打诨。
撮盐入火	cuo'yan'ru'huo	①抓取盐入火，燃烧更烈。形容性情急躁，一触即发作。②形容增添怒气。
撮盐入水	cuo'yan'ru'shui	①形容立刻消灭干净。②形容大而化之，什么都不在乎。
厝火积薪	cuo'huo'ji'xin	《汉书·贾谊传》：“夫抱火厝之积薪之下而寝其上，火未及燃，因谓之安，方今之势，何以异此。”谓置火于柴堆之下，比喻潜伏着极大危机。
厝火燎原	cuo'huo'liao'yuan	放火燎原，喻小乱子酿成大祸患。
措手不及	cuo'shou'bu'ji	事出突然，来不及应付。
措心积虑	cuo'xin'ji'lv	又作：处心积虑。谓长久考虑在心。
错彩镂金	cuo'cai'lou'jin	谓雕绘工丽。亦用以形容词藻华丽精美。
错节盘根	cuo'jie'pan'gen	①树木坚硬的根、节盘曲交错。多用以比喻事情错综复杂，难以处理。②形容人坚韧不拔。
错落不齐	cuo'luo'bu'qi	又作：参差不整齐。
错落高下	cuo'luo'gao'xia	又作：长短高低。
错落有致	cuo'luo'you'zhi	交错纷杂而有情趣。
达地知根	da'di'zhi'gen	谓根底清楚、明白。
达官贵人	da'guan'gui'ren	地位高的官吏和尊贵显赫的人物。
达官贵要	da'guan'gui'yao	又作：达官贵人。
达官显宦	da'guan'xian'huan	又作：达官贵人。
达官要人	da'guan'yao'ren	又作：达官贵人。
沓来麕至	ta'lai'jun'zhi	同“沓来踵至”。
沓来踵至	ta'lai'zhong'zhi	纷纷到来。
答非所问	da'fei'suo'wen	回答的内容不是人家要问的。
答问如流	da'wen'ru'liu	形容对答流暢。
打抱不平	da'bao'bu'ping	帮助受欺压者打击强横的人。
打草惊蛇	da'cao'jing'she	喻惩彼戒此。语本宋郑文宝《南唐近事》：“王鲁为当涂宰，颇以资产为务，会部民连状诉主簿贪贿于县尹，鲁乃判曰：‘汝虽打草，吾已蛞簿。’为好事者口实焉。”《里语证实·打草惊蛇》引《续常谈》作“汝虽打草，吾已惊蛇”。注云：“言汝诉主簿贪贿如打草，则我为蛇之被惊知戒矣。”后用以喻作事泄密而惊动对方。
打草蛇惊	da'cao'she'jing	见“打草惊蛇”。
打成一片	da'cheng'yi'pian	不同的部分融合为一个整体。
打凤捞龙	da'feng'lao'long	见“打凤牢龙”。
打凤牢龙	da'feng'lao'long	亦作“打凤捞龙”。①喻安排圈套使强有力的对手中计。②喻设法寻找合适的人选。
打富济贫	da'fu'ji'pin	夺取富人的财产，救济穷人。
打恭作揖	da'gong'zuo'yi	旧时礼节，弯身抱拳，上下摆动，表示恭敬。
打躬作揖	da'gong'zuo'yi	见“打恭作揖”。
打拱作揖	da'gong'zuo'yi	见“打恭作揖”。
打虎牢龙	da'hu'lao'long	又作：打凤牢龙。
打击报复	da'ji'bao'fu	对揭露自己缺点、错误的人进行压制陷害。
打鸡骂狗	da'ji'ma'gou	比喻旁敲侧击地漫骂，以发泄对某个人的不满。
打家劫舍	da'jia'jie'she	亦作“打家截舍”。到人家里抢劫财物。
打家截道	da'jia'jie'dao	谓到人家里和在路上抢夺财物。
打家截舍	da'jia'jie'she	见“打家劫舍”。
打开天窗说亮话	da'kai'tian'chuang'shuo'liang'hua	话】	直率而明白地讲出来。
打落水狗	da'luo'shui'gou	比喻继续打击那些已经失败了的敌人，不使死灰复燃。
打破沙锅问到底	da'po'sha'guo'wen'dao'di	底】	同“打破砂锅璺到底”。
打破沙锅璺到底	da'po'sha'guo'wen'dao'di	底】	亦作“打破砂锅璺到底”。璺，坼裂。谐声为“问”，今径改用“问”。比喻追根究底。语本宋黄庭坚《拙轩颂》：“觅巧了不可得，拙从何来？打破沙盆一问，狂子因此眼开，弄巧成拙，为蛇画足，何况头上安头，屋下安屋，毕竟巧者有馀，拙者不足。”
打破砂锅问到底	da'po'sha'guo'wen'dao'di	底】	见“打破沙锅问到底”。
打破砂锅璺到底	da'po'sha'guo'wen'dao'di	底】	见“打破沙锅璺到底”。
打情骂俏	da'qing'ma'qiao	带有亲昵或诱惑的相互嘲弄。多指男女调情。
打情骂趣	da'qing'ma'qu	①谓打是情，骂是趣。又作：打是亲，骂是爱。②犹打情骂俏。
打情卖笑	da'qing'mai'xiao	犹打情骂俏。
打蛇打七寸	da'she'da'qi'cun		比喻做事把握住关键，才易于制胜。
打死虎	da'si'hu	喻抨击已失威势的人。
打死老虎	da'si'lao'hu	见“打死虎”。
打铁趁热	da'tie'chen're	比喻做事抓紧时机，加速进行。
打退堂鼓	da'tui'tang'gu	①古时官吏打鼓退堂。②比喻中途退缩。
打鸭惊鸳	da'ya'jing'yuan	见“打鸭惊鸳鸯”。
打鸭惊鸳鸯	da'ya'jing'yuan'yang		比喻打此而惊彼。
大败亏轮	da'bai'kui'lun	遭到很大的失败和损失。
大笔如椽	da'bi'ru'chuan	语出《晋书·王珣传》：“珣梦人以大笔如椽与之，既觉，语人曰：‘此当有大手笔事。’俄而帝崩，哀册谥议，皆珣所草。”后常以“大笔如椽”夸赞别人文笔雄健有力或文章气势宏大。
大步流星	da'bu'liu'xing	形容走得很快。
大才榱槃	da'cai'cui'pan	同“大才槃槃”。
大才槃槃	da'cai'pan'pan	谓有大才干。
大材小用	da'cai'xiao'yong	大的材料用于小处。比喻人才使用不当，不能尽其才。
大彻大悟	da'che'da'wu	谓彻底醒悟。
大澈大悟	da'che'da'wu	见“大彻大悟”。
大吃一惊	da'chi'yi'jing	形容对发生的事感到十分意外。
大处落墨	da'chu'luo'mo	绘画或写文章要在主要的地方下工夫。比喻做事要在大处着眼。
大处着眼	da'chu'zhuo'yan	从大的、重要的方面观察、考虑问题。
大吹大打	da'chui'da'da	谓鼓乐齐作。
大吹大擂	da'chui'da'lei	①鼓乐齐作。②比喻大肆宣扬。
大吹法螺	da'chui'fa'luo	法螺，僧道作法事用的乐器，是一种梭尾螺壳。《妙法莲华经·序品》：“今佛世主，欲说大法，雨大法雨，吹大法螺，击大法鼓。”后以“大吹法螺”比喻说大话，大肆吹嘘。
大醇小疵	da'chun'xiao'ci	醇，纯。疵，病。谓大体纯正，略有欠缺。
大慈大悲	da'ci'da'bei	佛教语。佛菩萨对众生广大的慈善心和怜悯心。《大智度论》卷二七：“大慈大悲者，四无量心中已分别，今当更略说：大慈与一切众生乐，大悲拔一切众生苦。”后形容人心肠慈善。《云笈七签》卷四：“圣人兴，大慈大悲，爱若赤子，随时化生，随宜救拔。”现多含讽刺意。
大错特错	da'cuo'te'cuo	强调错误到极点。
大打出手	da'da'chu'shou	戏曲演武打时，由剧中一个角色同几个对手相互抛掷接踢武器，称为打出手。因以大打出手形容野蛮地打人逞凶或相互间的争斗、殴打。
大胆包身	da'dan'bao'shen	谓胆量极大。
大刀阔斧	da'dao'kuo'fu	①形容军队威猛的气势。②喻办事果断而有魄力。
大地春回	da'di'chun'hui	见“大地回春”。
大地回春	da'di'hui'chun	亦作“大地春回”。指冬尽春来。草木萌生，大地上呈现一片欣欣向荣的景象。常比喻形势的好转。
大动肝火	da'dong'gan'huo	大怒。
大而化之	da'er'hua'zhi	①谓光大德业，以化万民。②做事情马虎，不细心。
大而无当	da'er'wu'dang	①谓言辞夸大，不着边际。②指大而不切实用。
大发雷霆	da'fa'lei'ting	比喻大发脾气。
大法小廉	da'fa'xiao'lian	谓大臣尽忠，小臣尽职。
大方之家	da'fang'zhi'jia	谓见多识广、明晓大道的人。
大放厥词	da'fang'jue'ci	见“大放厥辞”。
大放厥辞	da'fang'jue'ci	亦作“大放厥词”。①谓写出大量优美的辞章。②大发议论（今多含贬义）。
大风大浪	da'feng'da'lang	自然界的狂风巨浪。多比喻社会上的巨大动荡和激烈斗争。
大腹便便	da'fu'bian'bian	①形容肚子肥大凸出。②今含贬义。
大公无私	da'gong'wu'si	①公平正直，不徇私情。②现多指完全为人民群众利益着想，毫无私心。
大功告成	da'gong'gao'cheng	语本《汉书·王莽传上》：“十万众并集，平作二旬，大功毕成。”指巨大的工程或重要的任务宣告完成。
大海捞针	da'hai'lao'zhen	比喻无从寻觅。
大旱望云	da'han'wang'yun	比喻渴望解除困境，如久旱盼望下雨一样。语本《孟子·梁惠王下》：“民望之，若大旱之望云霓也。”赵岐注：“霓，虹也。雨则虹见，故大旱而思见之。”
大好河山	da'hao'he'shan	无限美好的祖国国土。
大红大绿	da'hong'da'lv	谓颜色浓艳。
大红大紫	da'hong'da'zi	形容显赫、得意。
大呼小喝	da'hu'xiao'he	同“大呼小叫”。
大呼小叫	da'hu'xiao'jiao	谓大声叫呼。
大惑不解	da'huo'bu'jie	语本《庄子·天地》：“大惑者，终身不解；大愚者，终身不灵。”成玄英疏：“大愚惑者，凡俗也，心识闇鄙，触景生迷，所以竟世终身不觉悟也。”后多以“大惑不解”指对事物感到非常迷惑，不能理解。
大家风范	da'jia'feng'fan	①出自高贵人家的特有气派。②借称大作家的风格气派。
大家闺秀	da'jia'gui'xiu	旧指出身于世家大族的女子。
大匠运斤	da'jiang'yun'jin	语出《庄子·徐无鬼》：“郢人垩漫其鼻端，若蝇翼，使匠石斫之，匠石运斤成风，听而斫之，尽垩而鼻不伤，郢人立不失容。”后以“大匠运斤”称人技艺精湛或文笔娴熟高超。
大街小巷	da'jie'xiao'xiang	指各处街巷。
大经大法	da'jing'da'fa	根本的原则和法规。
大惊失色	da'jing'shi'se	非常惊恐，变了脸色。
大惊小怪	da'jing'xiao'guai	形容对不足为奇的事情过分慌张或诧异。
大快人心	da'kuai'ren'xin	指坏人受到惩罚或打击，众人心里感到非常痛快。
大塊文章	da'kuai'wen'zhang	原指大自然锦绣般美好的景色。语本唐李白《春夜宴从弟桃李园序》。清黄景仁《砚铭》：“眉山苍苍，大塊文章，兽纽头，篆鸟迹，中空无物，何止容卿辈数十。”后用以称赞别人内容丰富的长篇文章。参见“大塊”。
大路椎轮	da'lu'zhui'lun	南朝梁萧统《〈文选〉序》：“若夫椎轮为大辂之始，大辂宁有椎轮之质。”大辂，古代华美的大车。椎轮，无辐条的原始车轮。谓大辂由椎轮逐步演变而成，比喻事物的进化，由简到繁，由粗至精。后人亦称始创者为大辂椎轮。
大马金刀	da'ma'jin'dao	①形容豪爽，气派大。②形容说话直率锋利，不留情面。
大名鼎鼎	da'ming'ding'ding	名气很大。
大名难居	da'ming'nan'ju	《史记·越王勾践世家》：“句践以霸，而范蠡称上将军。还反国，范蠡以为大名之下，难以久居……乃装其轻宝珠玉，自与其私徒属乘舟浮海以行。”后称盛名之下不易自处为“大名难居”。
大谬不然	da'miu'bu'ran	谓大错特错，完全不是这样。
大缪不然	da'mou'bu'ran	见“大谬不然”。
大模大样	da'mo'da'yang	①满不在乎或不害怕的样子。②傲慢的样子。
大逆不道	da'ni'bu'dao	犹大逆无道。
大逆无道	da'ni'wu'dao	封建时代称犯上作乱等重大罪行。
大起大落	da'qi'da'luo	大幅度地起落。形容变化大。
大气磅礴	da'qi'bang'bo	形容气势盛大。
大器晚成	da'qi'wan'cheng	谓贵重器物需要长时间才能完成。常比喻大才之人成就往往较晚。
大千世界	da'qian'shi'jie	佛教语。“三千大千世界”之省称。后亦以指广阔无边的世界。
大巧若拙	da'qiao'ruo'zhuo	谓真正灵巧的人，不自炫耀，外似笨拙。
大请大受	da'qing'da'shou	谓优厚的待遇。
大权旁落	da'quan'pang'luo	重大权力落在别人手中。
大人先生	da'ren'xian'sheng	旧时指有身分有地位的人。有时带讽刺意味。
大杀风景	da'sha'feng'jing	唐李商隐《杂纂》把“花间喝道”、“月下把火”等列为“杀风景”的事情，意思是损害景物，破坏人的兴致。今泛称败人兴致为大杀风景。
大煞风景	da'sha'feng'jing	同“大杀风景”。
大煞风趣	da'sha'feng'qu	同“大煞风景”。
大声疾呼	da'sheng'ji'hu	大声呼喊，促使别人注意。语出唐韩愈《后十九日复上宰相书》：“蹈水火者之求免於人也，不惟其父兄子弟之慈爱，然后呼而望之也；将有介於其侧者，虽其所憎怨，苟不至乎欲其死者，则将大其声疾呼，而望其仁之也。”
大失所望	da'shi'suo'wang	原来的希望完全落空。语本《史记·高祖本记》：“秦人大失望。”
大势所趋	da'shi'suo'qu	整个局势发展的趋向。
大势已去	da'shi'yi'qu	谓有利的局势已经丧失。
大是大非	da'shi'da'fei	指带有原则性、根本性的是非问题。
大手大脚	da'shou'da'jiao	形容花钱、用东西没有节制。
大书特书	da'shu'te'shu	谓对大事郑重地予以记述。
大肆厥辞	da'si'jue'ci	铺张辞藻，大展文才。
大廷广众	da'ting'guang'zhong	见“大庭广众”。
大庭广众	da'ting'guang'zhong	本谓在朝廷之上，面对群臣的公开场所，后指人数众多的公开场合。
大同小异	da'tong'xiao'yi	《庄子·天下》：“大同而与小同异，此之谓小同异；万物毕同毕异，此之谓大同异。”后指事物大体相同，略有差异为“大同小异”。
大头小尾	da'tou'xiao'wei	犹虎头蛇尾。比喻作事前紧后松，有始无终。
大喜过望	da'xi'guo'wang	谓结果比原来希望的更好，因而感到特别高兴。
大厦将颠	da'sha'jiang'dian	喻情势危急，频临崩溃。
大厦将倾	da'sha'jiang'qing	见“大厦将颠”。
大显身手	da'xian'shen'shou	充分显露自己的本事。
大显神通	da'xian'shen'tong	充分显示出奇的本领。
大相径庭	da'xiang'jing'ting	见“大相迳庭”。
大相迳庭	da'xiang'jing'ting	谓彼此相差极远或矛盾很大。
大兴土木	da'xing'tu'mu	大规模兴建土木工程，多指盖房子。
大言不惭	da'yan'bu'can	说大话而不觉羞愧。
大吆小喝	da'yao'xiao'he	大声喊叫、谩骂。
大摇大摆	da'yao'da'bai	形容满不在乎、大模大样地走动。
大义凛然	da'yi'lin'ran	形容为维护正义而显出严峻不可侵犯的样子。
大义灭亲	da'yi'mie'qin	春秋时卫大夫石碏之子石厚与公子州吁杀桓公，而立州吁为君。石碏因设计杀州吁、石厚，《左传》赞之为“大义灭亲”。见《左传·隐公四年》。本指为君臣大义而绝父子的私情。后泛指为维护正义而不顾亲属间的私情。今指为维护正义，对违反祖国人民利益的亲属不徇私情，使受国法制裁。
大音希声	da'yin'xi'sheng	《老子》：“大音希声，大象无形。”王弼注：“听之不闻名曰希，不可得闻之音也。有声则有分，有分则不宫而商矣。分则不能统众，故有声者非大音也。”魏源本义引吕惠卿曰：“以至音而希声，象而无形，名与实常若相反者也，然则道之实盖隐於无矣。”意谓最大最美的声音乃是无声之音。
大有迳庭	da'you'jing'ting	《庄子·逍遥游》：“大有迳庭，不近人情焉。”王先谦集解引宣颖云：“迳，门外路；庭，堂外地；大有，谓相远之甚。”后称彼此差异很大为“大有迳庭”。
大有可为	da'you'ke'wei	事情很值得做，很有发展前途。
大有人在	da'you'ren'zai	指某一类人为数很多。
大有作为	da'you'zuo'wei	谓能充分发挥才能，做出很大成绩。
大展宏图	da'zhan'hong'tu	谓放手实施宏伟的计划和设想。
大张旗鼓	da'zhang'qi'gu	①比喻声势、规模很大。②比喻公开。
大张挞伐	da'zhang'ta'fa	①大规模地用兵征讨。②指进行猛烈抨击或声讨。
大杖则走	da'zhang'ze'zou	汉刘向《说苑·建本》：“舜之事父也，索而使之，未尝不在侧；求而杀之，未尝可得；小箠则待，大箠则走，以逃暴怒也。”谓父以大杖责子，或致伤，在父则为伤慈，子宜避之，不陷父于不义。
大直若诎	da'zhi'ruo'qu	见“大直若屈”。
大直若屈	da'zhi'ruo'qu	亦作“大直若诎”。最正直的人外表反似委曲随和。
大智如愚	da'zhi'ru'yu	谓才智极高的人，不炫耀自己，表面上看来好象愚笨。
大智若愚	da'zhi'ruo'yu	见“大智如愚”。
呆如木鸡	dai'ru'mu'ji	见“呆若木鸡”。
呆若木鸡	dai'ruo'mu'ji	《庄子·达生》谓纪渻子为国君驯养斗鸡，凡四十日乃成，“望之似木鸡矣”。因以“呆似木鸡”或“呆若木鸡”形容因恐惧或惊讶而发楞的样子。
呆似木鸡	dai'si'mu'ji	见“呆若木鸡”。
代马望北	dai'ma'wang'bei	比喻人心眷恋故土，不愿老死他乡。
代马依风	dai'ma'yi'feng	比喻人心眷恋故土，不愿老死他乡。
代越庖俎	dai'yue'pao'zu	《庄子·逍遥游》：“庖人虽不治庖，尸祝不越樽俎而代之矣。”成玄英疏：“庖人，谓掌庖厨之人，则今之太官供膳是也。尸者，太庙中神主也。祝者，则今太常太祝是也，执祭版对尸而祝之，故谓之尸祝也。樽，酒器也。俎，肉器也。”后因以“代越庖俎”比喻越出本分，代行其事。
带减腰围	dai'jian'yao'wei	语本《梁书·昭明太子统传》：“体素壮，腰带十围，至是减削过半。”常用以形容病愁瘦损。
带金佩紫	dai'jin'pei'zi	古时三公等皆佩带金印紫绶。后用以指居高官显位。
带水拖泥	dai'shui'tuo'ni	①形容泥泞难行。②比喻不顺利或不干脆。
带月披星	dai'yue'pi'xing	形容早起晚睡，奔波不息。
待贾而沽	dai'jia'er'gu	亦作“待价而沽”。等待善价出售，亦比喻怀才待用或待时而行。语本《论语·子罕》：“子贡曰：‘有美玉於斯，韫椟而藏诸？求善贾而沽诸？’子曰：‘沽之哉，沽之哉！我待贾者也。’”
待价而沽	dai'jia'er'gu	见“待贾而沽”。
待人接物	dai'ren'jie'wu	与人相处。
待兔守株	dai'tu'shou'zhu	比喻墨守成规不知变通或妄想不劳而获，坐享其成。
待月西厢	dai'yue'xi'xiang	唐元稹《莺莺传》载：莺莺约张生月夜会于花园，题《月明三五夜》诗一首，着红娘送去。其词曰：“待月西厢下，迎风户半开。拂墙花影动，疑是玉人来。”后因以“待月西厢”谓情人私相约会。
戴发含齿	dai'fa'han'chi	谓人的形状。亦以指人。
戴发含牙	dai'fa'han'ya	见“戴发含齿”。
戴高帽兒	dai'gao'mao'er	见“戴高帽子”。
戴高帽子	dai'gao'mao'zi	《北史·儒林传下·熊安生》：“道晖好着高翅帽、大屐，州将初临，辄服以谒见。仰头举肘，拜于屐上，自言学士比三公”。后因以妄自尊大，冀人誉己为好戴高帽子；而以吹捧、恭维别人为给人戴高帽子。
戴鸡佩豚	dai'ji'pei'tun	雄鸡野猪皆好斗，古时以冠带像其形，表示好勇。
戴笠乘车	dai'li'cheng'che	古代越地风俗淳朴，凡初与人交，即封土坛，祭以鸡犬，祝曰：“卿虽乘车我戴笠，后日相逢下车揖；我步行，君乘马，他日相逢君当下。”意即不以贵贱而使交情有所变易。见晋周处《风土记》。后以“戴笠乘车”喻贫贱之交或贵贱相逢，不忘旧交。
戴笠故交	dai'li'gu'jiao	谓贫贱之交。
戴眉含齿	dai'mei'han'chi	见“戴发含齿”。
戴盆望天	dai'pen'wang'tian	①《文选·司马迁〈报任少卿书〉》：“仆以为戴盆何以望天，故绝宾客之知，亡家室之业，日夜思竭其不肖之才力，务一心营职，以求亲媚於主上”。李善注：“言人戴盆则不得望天，望天则不得戴盆，事不可兼施”。因以“戴盆望天”喻事难两全。②喻方法错误，无法达到目的。
戴清履浊	dai'qing'lv'zhuo	犹戴天履地。清指天，浊指地。
戴日戴斗	dai'ri'dai'dou	又作：普天之下。
戴霜履冰	dai'shuang'lv'bing	形容不怕严寒，奔波于外。
戴天蹐地	dai'tian'ji'di	犹戴天履地。
戴天履地	dai'tian'lv'di	顶天立地。又作：生于天地之间。
戴头识脸	dai'tou'shi'lian	谓有面子，有身分。
戴玄履黄	dai'xuan'lv'huang	犹戴天履地。
戴圆履方	dai'yuan'lv'fang	犹戴天履地。
戴月披星	dai'yue'pi'xing	顶着月亮和星星。谓起早落黑，辛勤地奔波或在野外劳动。
戴罪立功	dai'zui'li'gong	谓判了罪而给予立功赎罪的机会。也泛指犯罪后立功赎罪。
丹凤朝阳	dan'feng'zhao'yang	《诗·大雅·卷阿》：“凤凰鸣矣，于彼高冈。梧桐生矣，于彼朝阳。”明硃善《诗解颐》卷三：“凤皇者，贤才之喻；高冈者，朝廷之喻；梧桐者，贤君之喻；朝阳者，明时之喻也。”后以“丹凤朝阳”喻贤才逢明时。
丹黄甲乙	dan'huang'jia'yi	点校书籍，评定次第。
丹漆随梦	dan'qi'sui'meng	南朝梁刘勰《文心雕龙·序志》：“齿在逾立，则尝梦执丹漆之礼器，随仲尼而南行。”后以“丹漆随梦”指追随前哲。
丹铅甲乙	dan'qian'jia'yi	见“丹黄甲乙”。
丹书白马	dan'shu'bai'ma	古代帝王赐给功臣享有世袭爵位和免罪等特权的证件时，宰白马歃其血，以示坚守誓约，后人称为“丹书白马”。
丹书铁契	dan'shu'tie'qi	古代帝王赐给功臣世袭的享有免罪等特权的证件。
丹书铁券	dan'shu'tie'quan	丹书铁契。
丹楹刻桷	dan'ying'ke'jue	红漆的柱子与刻有花纹的椽子。形容屋宇华丽精美。楹，柱。桷，椽。语出《春秋·庄公二十三年》：“秋，丹桓宫楹。”又《庄公二十四年》：“春，王三月，刻桓宫桷。”桷，椽。语出《春秋·庄公二十三年》：“秋，丹桓宫楹。”又《庄公二十四年》：“春，王三月，刻桓宫桷。”
单刀赴会	dan'dao'fu'hui	指三国蜀将关羽携带单刀独自往见吴将鲁肃的故事。后多喻指孤胆入敌，与之周旋。
单刀直入	dan'dao'zhi'ru	①原为佛教语。喻认定目标，勇猛精进。②喻说话直截了当，不绕弯子。
单见浅闻	dan'jian'qian'wen	见识短浅。
单枪匹马	dan'qiang'pi'ma	亦作“单枪独马”。亦作“单鎗匹马”。①形容孤身奋战。②比喻孤身一人或单独行动。
单丝不成线	dan'si'bu'cheng'xian		见“单丝不成线”。
单文孤证	dan'wen'gu'zheng	仅有的证据。意谓不足凭信。
单忧极瘁	dan'you'ji'cui	谓极尽忧虑辛劳之苦。单，通“殚”。
担惊受恐	dan'jing'shou'kong	见“担惊忍怕”。
担惊受怕	dan'jing'shou'pa	见“担惊忍怕”。
担雪塞井	dan'xue'sai'jing	比喻白费力气，于事无补。
担雪填河	dan'xue'tian'he	见“担雪塞井”。
担雪填井	dan'xue'tian'jing	见“担雪塞井”。
眈眈虎视	dan'dan'hu'shi	像老虎一般地威视着。语本《易·颐》：“虎视耽耽，其欲逐逐。”
眈眈逐逐	dan'dan'zhu'zhu	贪婪注视、急于攫取之貌。语出《易·颐》：“虎视眈眈，其欲逐逐。”
躭惊受怕	dan'jing'shou'pa	又作：担受惊吓。
殚诚毕虑	dan'cheng'bi'lv	竭尽忠诚与思虑。
殚见洽闻	dan'jian'qia'wen	谓见闻、知识十分广博。
殚精毕力	dan'jing'bi'li	尽心竭力。
殚精极虑	dan'jing'ji'lv	犹殚思极虑。
殚精竭力	dan'jing'jie'li	犹殚精毕力。
殚精竭虑	dan'jing'jie'lv	犹殚思极虑。
殚谋戮力	dan'mou'lu'li	竭尽智谋和精力。
殚思极虑	dan'si'ji'lv	谓竭尽心力思考谋划。
殚智竭力	dan'zhi'jie'li	竭尽智慧和力量。
箪豆见色	dan'dou'jian'se	谓计较小利。语出《孟子·尽心下》：“好名之人能让千乘之国，苟非其人，箪食豆羹见於色。”
箪醪投川	dan'lao'tou'chuan	相传古有良将，得到别人赠送的一箪酒，为了表示与部下共享，把酒倒在河里，让兵士从下游取水饮之。事见汉黄石公《三略·上略》。或以为越王勾践事，见《吕氏春秋·顺民》。后以“箪醪投川”为将领爱抚部下，甘苦与共的典实。
箪瓢陋室	dan'piao'lou'shi	又作：箪瓢陋巷。
箪瓢陋巷	dan'piao'lou'xiang	《论语·雍也》载：颜渊一箪食，一瓢饮，居陋巷，而不改其乐，孔子称赞他说：“贤哉回也！”后以“箪瓢陋巷”为生活清贫的典故。
箪瓢屡空	dan'piao'lv'kong	谓饮食不继，生活贫困。
箪瓢屡罄	dan'piao'lv'qing	又作：箪瓢屡空。
箪食豆羹	dan'shi'dou'geng	一箪饭食，一豆羹汤。谓少量饮食。亦以喻小利。
箪食壶浆	dan'shi'hu'jiang	①用箪装着饭食，用壶盛着浆汤。《孟子·梁惠王下》：“以万乘之国伐万乘之国，箪食壶浆以迎王师，岂有他哉！避水火也。”后用为犒师拥军的典故。②用箪装着饭食，用壶盛着浆汤。《公羊传·昭公二十五年》：“高子执箪食与四脡脯，国子执壶浆，曰：‘吾寡君闻君在外，馂饔未就，敢致糗于从者。’”后用为饷馈食饮的典故。
箪食壶酒	dan'shi'hu'jiu	一箪食，一壶酒。谓少量饮食。
箪食瓢饮	dan'shi'piao'yin	《论语·雍也》：“一箪食，一瓢饮，在陋巷，人不堪其忧，回也不改其乐。贤哉回也！”后用为生活简朴，安贫乐道的典故。
儋石之储	dan'shi'zhi'chu	又作：少量的财富。
胆颤心惊	dan'chan'xin'jing	同“胆战心惊”。
胆粗气壮	dan'cu'qi'zhuang	谓胆大气盛，无所畏惧。
胆大包天	dan'da'bao'tian	极言胆子很大，不知畏惧。
胆大泼天	dan'da'po'tian	同“胆大包天”。
胆大如斗	dan'da'ru'dou	《三国志·蜀志·姜维传》“维妻子皆伏诛”裴松之注引《世语》：“维死时见剖，胆如斗大。”后因称胆量极大为“胆大如斗”。元关汉卿《单刀会》第二折：“有一个赵子龙胆大如斗。”亦省作“胆如斗”。宋黄庭坚《再答明略》诗之二：“廖侯言如不出口，铨量古今胆如斗。”一说，“如斗”应作“如升”。
胆大妄为	dan'da'wang'wei	形容无所忌惮地胡作非为。
胆大心粗	dan'da'xin'cu	谓做事胆子大，但粗疏鲁莽欠思考。
胆大心细	dan'da'xin'xi	勇于任事而又缜密谨慎。
胆大心雄	dan'da'xin'xiong	胆子大，有雄心，做事无所畏惧。
胆大於身	dan'da'yu'shen	又作：胆大如斗。谓无所忌惮。语出《旧唐书·李昭德传》载丘愔劾奏李昭德语：“臣观其胆，乃大於身，鼻息所冲，上拂云汉。”
胆寒发竖	dan'han'fa'shu	形容恐怖之极。
胆裂魂飞	dan'lie'hun'fei	极言恐惧之甚。
胆丧魂惊	dan'sang'hun'jing	同“胆裂魂飞”。
胆丧魂消	dan'sang'hun'xiao	同“胆裂魂飞”。
胆小如豆	dan'xiao'ru'dou	极言胆子小。
胆小如鼠	dan'xiao'ru'shu	语本《魏书·汝阴王天赐传》：“言同百舌，胆若鼷鼠。”后以“胆小如鼠”或“胆小如鼷”形容胆量极小。
胆小如鼷	dan'xiao'ru'xi	见“胆小如鼠”。
胆战心寒	dan'zhan'xin'han	惊慌恐惧之极。
胆战心慌	dan'zhan'xin'huang	同“胆战心惊”。
胆战心惊	dan'zhan'xin'jing	形容非常害怕。
胆战心摇	dan'zhan'xin'yao	同“胆战心惊”。
胆壮气粗	dan'zhuang'qi'cu	见“胆粗气壮”。
胆壮心雄	dan'zhuang'xin'xiong	见“胆大心雄”。
诞幻不经	dan'huan'bu'jing	怪诞虚幻，不合常理。
诞谩不经	dan'man'bu'jing	荒诞虚妄，不合常理。
诞罔不经	dan'wang'bu'jing	见“诞妄不经”。
诞妄不经	dan'wang'bu'jing	荒诞虚妄，不合常理。
弹冠结绶	dan'guan'jie'shou	朋友之间互相援引出仕。
弹冠相庆	dan'guan'xiang'qing	《汉书·王吉传》：“吉与贡禹为友，世称‘王阳在位，贡公弹冠’，言其取舍同也。”本谓王吉（王阳）、贡禹友善，王吉做官，贡禹也准备出仕。后以“弹冠相庆”指互相庆贺。多用作贬义。
弹冠振衿	dan'guan'zhen'jin	见“弹冠振衣。”
弹冠振衣	dan'guan'zhen'yi	整洁衣冠。语本《楚辞·渔父》：“新沐者必弹冠，新浴者必振衣。”后多以喻将欲出仕。
弹斤估两	dan'jin'gu'liang	形容掂量轻重。
弹空说嘴	dan'kong'shuo'zui	又作：唱高调说空话。
弹丸黑志	dan'wan'hei'zhi	见“弹丸黑子”。
弹丸黑子	dan'wan'hei'zi	亦作“弹丸黑志”。喻极小。语出北周庾信《哀江南赋》：“地惟黑子，城犹弹丸。”
弹丸脱手	dan'wan'tuo'shou	比喻作诗圆润精美、敏捷流暢。
弹雨枪林	dan'yu'qiang'lin	弹下如雨，枪立如林。形容战斗剧烈。
淡而不厌	dan'er'bu'yan	①指诗文恬淡而不乏味。②犹漫不经心。
淡而无味	dan'er'wu'wei	①没趣味。②没味道。
淡饭黄齑	dan'fan'huang'ji	泛指很差的饭菜。
淡扫蛾眉	dan'sao'e'mei	轻淡地画眉。指妇女淡雅的化妆。
淡水交情	dan'shui'jiao'qing	不以势利为基础的友情。指君子之交。语本《庄子·山木》：“君子之交淡若水。”
淡写轻描	dan'xie'qing'miao	犹细写细描。谓描写细致。
淡妆浓抹	dan'zhuang'nong'mo	见“淡妆浓抹”。
淡妆轻抹	dan'zhuang'qing'mo	略加妆饰打扮。
当场出彩	dang'chang'chu'cai	旧时戏剧表演杀伤时，用红水涂抹，装作流血的样子，叫做出彩。今用以喻在人前败露秘密或出丑。
当场出丑	dang'chang'chu'chou	在大庭广众露出丑相，丢脸。
当断不断	dang'duan'bu'duan	该作出决断的时候不能决断。形容临事犹豫不决。
当耳边风	dang'er'bian'feng	当做耳边吹过的风。比喻对所听的话不放在心上。语本汉赵晔《吴越春秋·吴王寿梦传》：“富贵之於我，如秋风之过耳。”
当耳旁风	dang'er'pang'feng	见“当耳边风”。
当机立断	dang'ji'li'duan	抓住时机，立刻决断。
当机立决	dang'ji'li'jue	抓住时机，立刻判决。
当家理纪	dang'jia'li'ji	谓管理家务。
当家立计	dang'jia'li'ji	主持家政，筹划生计。
当家立纪	dang'jia'li'ji	见“当家理纪”。
当家立事	dang'jia'li'shi	见“当家立业”。
当家立业	dang'jia'li'ye	主持家业。
当家作主	dang'jia'zuo'zhu	本指主管家政，有权对家事作出决定。亦比喻在单位或国家中居主人翁地位。
当家做主	dang'jia'zuo'zhu	见“当家作主”。
当今无辈	dang'jin'wu'bei	目前没人能比得上。辈，比。
当局者迷	dang'ju'zhe'mi	谓身当其事者反而糊涂。
当立之年	dang'li'zhi'nian	指三十岁。语本《论语·为政》：“三十而立。”
当仁不让	dang'ren'bu'rang	《论语·卫灵公》：“当仁不让於师。”硃熹集注：“当仁，以仁为己任也；虽师亦无所逊。言当勇往而必为也。”后泛指遇到应该做的事主动去做，绝不推诿。
当世无双	dang'shi'wu'shuang	当代独一无二。
当头棒喝	dang'tou'bang'he	佛教禅宗祖师为了打破学人的凡想迷情，棒喝交驰，作为特殊的施教方式。“棒”始于宣鉴，“喝”始于道一。《五灯会元·黄檗运禅师法嗣·临济义玄禅师》：“上堂，僧问：‘如何是佛法大意？’师亦竖拂子，僧便喝，师亦喝。僧拟议，师便打。”后以“当头棒喝”比喻促人醒悟的打击或警告。
当头一棒	dang'tou'yi'bang	①比喻给人以严重警告或打击。②比喻直截了当，毫不含蓄。
当务之急	dang'wu'zhi'ji	当前急切应办的要事。语出《孟子·尽心上》：“知者无不知也，当务之为急。”
当刑而王	dang'xing'er'wang	《汉书·黥布传》：“少时客相之，当刑而王。及壮，坐法黥，布欣然笑曰：‘人相我当刑而王，几是乎？’”后谓先经受磨难而后飞腾黄达。
当行出色	dang'xing'chu'se	做本行的事，成绩特别显著。
当之无愧	dang'zhi'wu'kui	当得起某种称号或荣誉而无愧色。
当轴处中	dang'zhou'chu'zhong	正处在车轴中心的位置。比喻官居要职。
党恶佑奸	dang'e'you'jian	偏护奸恶。
党坚势盛	dang'jian'shi'sheng	谓团结紧、势力盛大。
党同妒异	dang'tong'du'yi	又作：党同伐异。
党同伐异	dang'tong'fa'yi	与自己观点相同的就袒护，与自己观点不同就加以攻击。
党邪丑正	dang'xie'chou'zheng	又作：党邪陷正。
党邪陷正	dang'xie'xian'zheng	与坏人结伙，陷害好人。
荡产倾家	dang'chan'qing'jia	谓丧失全部家产。
荡魂摄魄	dang'hun'she'po	震撼心神。
荡检逾閒	dang'jian'yu'xian	见“荡检逾闲”。
荡检逾闲	dang'jian'yu'xian	见“荡检逾闲”。
荡检逾闲	dang'jian'yu'xian	谓行为放荡，不守礼法。检、闲，指规矩、法制。
荡气回肠	dang'qi'hui'chang	谓一种陶醉人的气氛回荡在情绪和感觉中。
荡气回肠	dang'qi'hui'chang	形容文词、音乐等感人至深。
荡然无存	dang'ran'wu'cun	全都毁坏，消失尽净。
刀耕火耨	dao'geng'huo'nou	刀耕火种。
刀耕火耘	dao'geng'huo'yun	犹刀耕火种。
刀耕火种	dao'geng'huo'zhong	古代山地的耕种方法。亦泛指原始的耕种方法。
刀光剑影	dao'guang'jian'ying	形容激烈的厮杀、搏斗或杀气腾腾的气势。
刀光血影	dao'guang'xue'ying	形容血腥的杀戮。
刀锯鼎镬	dao'ju'ding'huo	四者皆古代刑具。借指酷刑。
刀锯斧钺	dao'ju'fu'yue	四者皆古代刑具。借指严刑。
刀枪剑戟	dao'qiang'jian'ji	泛指武器。
刀山火海	dao'shan'huo'hai	喻极险恶的境地。
刀山剑树	dao'shan'jian'shu	①佛教语。地狱酷刑之一。②为古代酷刑。③喻极危险的境地。
刀头剑首	dao'tou'jian'shou	极喻危险的境遇。
刀头燕尾	dao'tou'yan'wei	喻笔锋劲利。
刀俎馀生	dao'zu'yu'sheng	犹虎口余生。
岛瘦郊寒	dao'shou'jiao'han	指唐贾岛和孟郊的诗歌风格。岛郊诗作多清切凄苦，因以并举。
倒背如流	dao'bei'ru'liu	把文章倒过来背诵，能象流水一样顺暢。形容书读得极熟。
倒持干戈	dao'chi'gan'ge	又作：倒持泰阿。干、戈，皆兵器。
倒持戈矛	dao'chi'ge'mao	又作：倒持泰阿。戈、矛，皆兵器。
倒持手板	dao'chi'shou'ban	见“倒执手版”。
倒持太阿	dao'chi'tai'a	见“倒2持泰阿”。
倒持泰阿	dao'chi'tai'a	倒持宝剑，将剑把交给别人。比喻轻率地授人权柄，自己反受其害。
倒打一耙	dao'da'yi'ba	《西游记》中猪八戒以钉耙作武器，后来俗语有“猪八戒倒打一耙”的说法，多指不仅不接受对方的意见，反而指摘对方。
倒打一瓦	dao'da'yi'wa	又作：倒打一耙。
倒凤颠鸾	dao'feng'dian'luan	①喻男女间的性行为。②指织品上的花纹图案。
倒冠落佩	dao'guan'luo'pei	见“倒冠落珮”。
倒冠落珮	dao'guan'luo'pei	亦作“倒冠落佩”。①指弃官归隐。冠、珮是官员正服的打扮。②指隐者装束。
倒果为因	dao'guo'wei'yin	颠倒因果关系，把结果当作原因。
倒海翻江	dao'hai'fan'jiang	①原谓波涛汹涌，水势浩大。亦用以形容雨暴风狂。②形容山势绵延起伏。③形容心情无比激动。
倒戢干戈	dao'ji'gan'ge	见“倒载干戈”。
倒街卧巷	dao'jie'wo'xiang	谓露宿街头。
倒廪倾囷	dao'lin'qing'qun	倾倒出粮仓中全部储藏。比喻罄其所有、尽其所知。
倒箧倾筐	dao'qie'qing'kuang形	容倾其所有。
倒箧倾囊	dao'qie'qing'nang	倾囊倒箧。形容倾尽其所有。
倒三颠四	dao'san'dian'si	犹颠三倒四。谓说话、做事颠倒错乱。
倒山倾海	dao'shan'qing'hai	形容摧毁破坏极大。
倒魨孩怼	dao'tun'hai'dui	接生婆把婴孩包扎倒了，比喻多年老手，对平素熟习之事一时失误。
倒峡泻河	dao'xia'xie'he	比喻文笔酣暢，气势磅礴。
倒行逆施	dao'xing'ni'shi	做事违反常规或违背情理。语本《史记·伍子胥列传》：“吾日莫途远，吾故倒行而逆施之。”司马贞索隐：“譬如人行，前途尚远，而日势已莫，其在颠倒疾行，逆理施事，何得责吾顺理乎！”
倒因为果	dao'yin'wei'guo	颠倒因果关系，把原因说成结果。
倒载干戈	dao'zai'gan'ge	倒着藏放兵器，表示不再打仗。
倒执手版	dao'zhi'shou'ban	古代官员持手版以朝。倒执手版，谓惊惶失态。
倒置干戈	dao'zhi'gan'ge	见“倒载干戈”。
捣虚批吭	dao'xu'pi'hang	同“批亢捣虚”。乘虚攻击敌方要害。
蹈常習故	dao'chang'xi'gu	谓按照老规矩和老办法办事。
蹈常袭故	dao'chang'xi'gu	见“蹈常習故”。
蹈锋饮血	dao'feng'yin'xue	形容勇敢，不怕牺牲。
蹈赴汤火	dao'fu'tang'huo	同“蹈汤赴火”。
蹈故習常	dao'gu'xi'chang	见“蹈常習故”。
蹈规循矩	dao'gui'xun'ju	同“蹈矩循规”。
蹈火赴汤	dao'huo'fu'tang	同“蹈汤赴火”。
蹈火探汤	dao'huo'tan'tang	同“蹈汤赴火”。
蹈机握杼	dao'ji'wo'zhu	脚踩布机，手握筘梭。比喻掌握着事物发展变化的枢键。
蹈矩践墨	dao'ju'jian'mo	同“蹈矩循规”。
蹈矩循规	dao'ju'xun'gui	遵守规矩。
蹈矩循彟	dao'ju'xun'huo	同“蹈矩循规”。
蹈仁履义	dao'ren'lv'yi	遵循仁义之道。
蹈汤赴火	dao'tang'fu'huo	比喻不避艰险。
悼心疾首	dao'xin'ji'shou	心里伤感，头部疼痛。形容悲痛到了极点。
悼心失图	dao'xin'shi'tu	谓内心哀痛而失去主张。《左传·昭公七年》：“孤与其二三臣悼心失图，社稷之不皇，况能怀思君德！”杜预注：“在哀丧故。”一说悼通“掉”，悼心失图，谓心中摇摆而失去主张。
盗铃掩耳	dao'ling'yan'er	同“盗锺掩耳”。
盗名欺世	dao'ming'qi'shi	窃取名声以欺骗世人。
盗嫂受金	dao'sao'shou'jin	《史记·陈丞相世家》载，绛侯、灌婴等咸谗陈平曰：臣闻平居家时，盗其嫂；臣闻平受诸将金，金多者得善处，金少者得恶处。于是汉王疑之。后遂以“盗嫂受金”为因小眚而遭谗被疑的典实。
盗食致饱	dao'shi'zhi'bao	比喻以不正当手段获益。
盗亦有道	dao'yi'you'dao	谓盗者亦有其为盗之道义。
盗玉窃钩	dao'yu'qie'gou	比喻一切大小窃取之事。玉，贵物；钩，贱物。
盗怨主人	dao'yuan'zhu'ren	见“盗憎主人”。
盗憎主人	dao'zeng'zhu'ren	比喻奸恶的人怨恨正直的人。语出《左传·成公十五年》：“伯宗每朝，其妻必戒之曰：‘盗憎主人，民恶其上，子好直言，必及於难。’”
盗锺掩耳	dao'zhong'yan'er	《吕氏春秋·自知》：“有得锺者，欲负而走，则锺大不可负，以椎毁之，锺况然有音，恐人闻之而夺己也，遽揜（掩）其耳。”后以“盗锺掩耳”比喻自己欺骗自己。
道傍苦李	dao'bang'ku'li	同“道边苦李”。
道傍之筑	dao'bang'zhi'zhu	喻无法成功的事。语出《诗·小雅·小旻》：“如彼筑室于道谋，是用不溃于成。”郑玄笺：“如当路筑室，得人而与之谋所为，路人之意不同。故不得遂成也。”
道傍筑室	dao'bang'zhu'shi	语出《诗·小雅·小旻》：“如彼筑室于道谋，是用不溃于成。”郑玄笺：“如当路筑室，得人而与之谋所为，路人之意不同。故不得遂成也。”后比喻杂采各家之说。
道边苦李	dao'bian'ku'li	典出南朝宋刘义庆《世说新语·雅量》：“王戎七岁，尝与诸小兒游，看道边李树多子折枝，诸兒竞走取之，唯戎不动。人问之，答曰：‘树在道边而多子，此必苦李。’取之信然。”后以喻庸才，无用之才。
道不掇遗	dao'bu'duo'yi	同“道不拾遗”。
道不举遗	dao'bu'ju'yi	同“道不拾遗”。
道不拾遗	dao'bu'shi'yi	谓路有失物，无人拾取。古时用以形容刑法严峻或民风淳厚。
道不相谋	dao'bu'xiang'mou	谓思想志向不同的人不会在一起共事。语本《论语·卫灵公》：“子曰：‘道不同，不相为谋。’”
道长论短	dao'chang'lun'duan	谓评论好坏是非。
道长争短	dao'chang'zheng'duan	见“道长论短”。
道存目击	dao'cun'mu'ji	语出《庄子·田子方》：“子路曰：‘吾子欲见温伯雪子久矣，见之而不言，何邪？’仲尼曰：‘若夫人者，目击而道存矣，亦不可以容声矣。’”王先谦集解引宣颖曰：“目触之而知道在其身，复何所容其言说邪？”谓一个人具有深厚的道德修养，人们只在略一顾瞻之中便能感受得到。
道弟称兄	dao'di'cheng'xiong	朋友间以兄弟相称，表示关系亲密。
道东说西	dao'dong'shuo'xi	见“道西说东”。
道而不径	dao'er'bu'jing	谓走路不走小路，以免危险。
道高德重	dao'gao'de'zhong	道德高尚，很有威信。
道高魔重	dao'gao'mo'zhong	形容法力高强。
道高望重	dao'gao'wang'zhong	又作：德高望重。
道高一尺，魔高一丈	dao'gao'yi'chi'-'mo'gao'yi'zhang	高一丈】	①原为佛教语，告诫修行者警惕外界诱惑。谓正气难以修得，而邪气容易高过正气。②比喻一事物兴起，又有一事物超越其上。③比喻一方的力量超过与之敌对的另一方。
道骨仙风	dao'gu'xian'feng	谓有得道者及仙人的气质神采。
道寡称孤	dao'gua'cheng'gu	谓自封为王，称霸一方。
道合志同	dao'he'zhi'tong	谓彼此的志趣理想一致。
道尽涂殚	dao'jin'tu'dan	见“道尽涂穷”。
道尽涂穷	dao'jin'tu'qiong	谓无路可走，陷于绝境。
道尽途殚	dao'jin'tu'dan	同“道尽涂穷”。
道尽途穷	dao'jin'tu'qiong	同“道尽涂穷”。
道殣相望	dao'jin'xiang'wang	谓路上饿死的人很多。
道殣相枕	dao'jin'xiang'zhen	见“道殣相望”。
道殣相属	dao'jin'xiang'shu	见“道殣相望”。
道路以目	dao'lu'yi'mu	路上相见，以目示意，不敢交谈。多表示政治黑暗暴虐。
道貌岸然	dao'mao'an'ran	容色神态庄严的样子。
道貌凛然	dao'mao'lin'ran	犹道貌岸然。
道貌俨然	dao'mao'yan'ran	见“道貌岸然”。
道旁苦李	dao'pang'ku'li	同“道边苦李”。
道山学海	dao'shan'xue'hai	形容学识渊博。
道听耳食	dao'ting'er'shi	对传闻之辞不加去取，盲目轻信。
道听涂说	dao'ting'tu'shuo	同“道听涂说”。
道听涂说	dao'ting'tu'shuo	从道路上听到，在道路上传说。泛指没有根据的传闻。
道听涂说	dao'ting'tu'shuo	从道路上听到，在道路上传说。泛指没有根据的传闻。
道听途说	dao'ting'tu'shuo	同“道听涂说”。
道同契合	dao'tong'qi'he	又作：道合志同。
道同义合	dao'tong'yi'he	又作：道合志同。
道同志合	dao'tong'zhi'he	又作：道合志同。
道头会尾	dao'tou'hui'wei	见“道头知尾”。
道头知尾	dao'tou'zhi'wei	说个开头就知道结果。形容思维敏捷、悟性好。
道微德薄	dao'wei'de'bao	道行和才能都很差。多作谦辞。
道无拾遗	dao'wu'shi'yi	同“道不拾遗”。
道西说东	dao'xi'shuo'dong	谓乱加谈论。
道远知骥	dao'yuan'zhi'ji	路远才知道马的好坏。
道在人为	dao'zai'ren'wei	又作：事在人为。
道在屎溺	dao'zai'shi'ni	喻道之无所不在。
得不补失	de'bu'bu'shi	见“得不偿失”。
得不偿丧	de'bu'chang'sang	见“得不偿失”。
得不偿失	de'bu'chang'shi	所得到的不足以补偿所失去的。
得不酬失	de'bu'chou'shi	见“得不偿失”。
得步进步	de'bu'jin'bu	又作：得寸进尺。
得寸得尺	de'cun'de'chi	《战国策·秦策三》：“王不如远交而近攻，得寸则王之寸，得尺亦王之尺也。”谓或多或少皆有所得。后亦谓能得多少就得多少。
得寸进尺	de'cun'jin'chi	比喻贪得无厌。
得道多助	de'dao'duo'zhu	谓符合道义者则能得到多数人的帮助。语出《孟子·公孙丑下》：“得道者多助，失道者寡助。寡助之至，亲戚畔之；多助之至，天下顺之。”
得过且过	de'guo'qie'guo	①谓但能度日，即勿他求。元无名氏《小孙屠》戏文第四出：“孩兒，我听得道你要出外打旋，怕家中得过且过，出去做甚的？”后谓安于现状，敷衍度日。②指办事马虎。敷衍塞责。
得陇望蜀	de'long'wang'shu	《东观汉记·隗嚣传》：“西城若下，便可将兵，南击蜀虏。人苦不知足，既平陇，复望蜀，每一发兵，头鬓为白。”后遂以“得陇望蜀”喻贪心不足。
得马生灾	de'ma'sheng'zai	《淮南子·人间训》：“近塞上之人，有善术者，马无故亡而入胡……居数月，其马将胡骏马而归，人皆贺之。其父曰：‘此何遽不能为祸乎？’家富良马，其子好骑，堕而折其髀。”后以“得马生灾”谓因福而得祸。
得马失马	de'ma'shi'ma	谓世事多变，得失无常。典出《淮南子·人间训》。
得马折足	de'ma'zhe'zu	见“得马生灾”。
得其所哉	de'qi'suo'zai	亦省作“得其所”。①谓得到合适的处所或位置。语出《孟子·万章上》：“昔者有馈生鱼於郑子产，子产使校人畜之池。校人烹之，反命曰：‘始舍之，圉圉焉；少则洋洋焉；攸然而逝。’子产曰：‘得其所哉！得其所哉！’”②形容十分得意。
得胜回朝	de'sheng'hui'zhao	①打了胜仗后返回朝廷向皇帝报功。②泛指胜利而归，每含贬义。
得手应心	de'shou'ying'xin	见“得心应手”。
得天独厚	de'tian'du'hou	独具特殊优越的条件。
得兔忘蹄	de'tu'wang'ti	又作：得鱼忘荃。蹄，兔罝。语出《庄子·外物》：“蹄者所以在兔，得兔而忘蹄。”
得未尝有	de'wei'chang'you	见“得未曾有”。
得未曾有	de'wei'zeng'you	谓前所未有，今始得之。
得意忘象	de'yi'wang'xiang	谓只取其精神而无视其形式。
得意忘形	de'yi'wang'xing	①《晋书·阮籍传》：“嗜酒能啸，善弹琴。当其得意，忽忘形骸。”谓因高兴而物我两忘。后以“得意忘形”形容高兴得失去常态，忘乎所以。②谓取其精神而舍其形式。
得意忘言	de'yi'wang'yan	①谓既已领会其意旨，则不再需要表意之言词。语出《庄子·外物》：“言者所以在意，得意而忘言。”②引申为彼此默喻，心照不宣。
得意扬扬	de'yi'yang'yang	见“得意洋洋”。
得意洋洋	de'yi'yang'yang	亦作“得意扬扬”。形容十分得意的样子。语本《史记·管晏列传》：“意气扬扬，甚自得也。”
得鱼忘荃	de'yu'wang'quan	比喻已达目的，即忘其凭借。“荃”亦作“筌”。
得鱼忘筌	de'yu'wang'quan	见“得鱼忘荃”。
德本财末	de'ben'cai'mo	谓治国平天下，德为根本，财由德致，故理财为末。语本《礼记·大学》：“德者，本也；财者，末也。”孔颖达疏：“德能致财，财由德有，故德为本财为末也。”
德才兼备	de'cai'jian'bei	良好的思想品德和能力才干两者都具备。
德高望重	de'gao'wang'zhong	道德高尚，名望很大。多用于称年长而名位高的人。
德厚流光	de'hou'liu'guang	谓德泽深厚则影响深远，子孙得福。语本《穀梁传·僖公十五年》：“天子七庙，诸侯五，大夫三，士二，故德厚者流光，德薄者流卑。”锺文烝补注：“光与广同。”
德隆望重	de'long'wang'zhong	又作：德高望重。
德隆望尊	de'long'wang'zun	见“德隆望重”。
德配天地	de'pei'tian'di	谓道德可与天地匹配。极言道德之高尚盛大。
德容言功	de'rong'yan'gong	见“德言容功”。
德胜头迴	de'sheng'tou'hui	犹得胜头回。德，通“得”。迴，同“回”。宋明话本、通俗小说的引首。
德言工貌	de'yan'gong'mao	见“德言容功”。
德言工容	de'yan'gong'rong	见“德言容功”。
德言容功	de'yan'rong'gong	指妇德、妇言、妇容、妇功。封建礼教要求妇女具备的四种德行。语本《礼记·昏义》：“是以古者妇人先嫁三月……教以妇德、妇言、妇容、妇功。”郑玄注：“妇德，贞顺也；妇言，辞令也；妇容，婉娩也；妇功，丝麻也。”亦作“德容言功”、“德言工貌”、“德言工容”。
德洋恩普	de'yang'en'pu	谓德泽优渥普及。
德輶如毛	de'you'ru'mao	德轻得象羽毛一样。谓施行仁德并不困难，而在于其志向有否。
德輶如羽	de'you'ru'yu	见“德輶如毛”。
德尊望重	de'zun'wang'zhong	见“德高望重”。
的一确二	di'yi'que'er	又作：一是一，二是二。形容说话句句真实。
灯蛾扑火	deng'e'pu'huo	比喻自惹祸害。
灯红酒绿	deng'hong'jiu'lv	①形容夜宴之盛。②以形容奢糜华丽的生活。
登峰造极	deng'feng'zao'ji	①登上山峰绝顶。②喻造诣达到极高的境地。③喻某种事物发展到极点。
登锋履刃	deng'feng'lv'ren	踩踏刀剑的锋刃。比喻冲锋陷阵在最前头。
登锋陷阵	deng'feng'xian'zhen	冲锋陷阵。形容作战英勇。
登高必赋	deng'gao'bi'fu	古代指大夫必须具备的九种才能之一。谓登高见广，能赋诗述其感受。
登高履危	deng'gao'lv'wei	喻诚惶诚恐。
登高能赋	deng'gao'neng'fu	见“登高必赋”。
登高自卑	deng'gao'zi'bei	谓事情必须循序渐进。
登界游方	deng'jie'you'fang	登上天界，游历四方。指周游世界。
登木求鱼	deng'mu'qiu'yu	爬到树上寻找鱼。比喻方向、方法不对，一定达不到目的。
登山临水	deng'shan'lin'shui	登上高山，面临流水。谓在山水间盘桓。
登山涉水	deng'shan'she'shui	爬山过水。喻历尽艰难。
登台拜将	deng'tai'bai'jiang	见“登坛拜将”。
登坛拜将	deng'tan'bai'jiang	《史记·淮阴侯列传》：“何曰：‘王素慢无礼，今拜大将如呼小兒耳，此乃信所以去也。王必欲拜之，择良日，斋戒，设坛场。具礼，乃可耳。’王许之。”后因以“登坛拜将”借指任命将帅或委以重任。
登堂入室	deng'tang'ru'shi	①登上F堂，进入内室。②比喻学艺造诣精绝，深得师传。③比喻学问或技能由浅入深，达到更高的水平或境界。
等而上之	deng'er'shang'zhi	按某一等次，由此再往上。
等而下之	deng'er'xia'zhi	按某一等次，由此再往下；低于某一等级标准。
等价连城	deng'jia'lian'cheng	同样有连城之价。形容同等珍贵。
等閒人家	deng'xian'ren'jia	普通家庭。
等閒视之	deng'xian'shi'zhi	见“等闲视之”。
等礼相亢	deng'li'xiang'kang	又作：分庭抗礼。以平等之礼相待。
等量齐观	deng'liang'qi'guan	指对有差别的事物同等看待。
等米下锅	deng'mi'xia'guo	①形容境况很窘迫。②比喻由于某种急需，等着得到某些东西。
等身著作	deng'shen'zhu'zuo	叠起来与身高相等的著作。形容著作之多。
等闲视之	deng'xian'shi'zhi	亦作“等閒视之”。当平常事情看待。多用于否定句。
等夷之心	deng'yi'zhi'xin	见“等夷之志”。
等夷之志	deng'yi'zhi'zhi	《诗·大雅·桑柔》“贪人败类”郑玄笺：“类，等夷也。”孔颖达疏：“类，比类，故为等夷，谓尊卑齐平朝庭之人。”后因以“等夷之志”谓臣下僭越朝廷之心。
瞪眉瞠眼	deng'mei'cheng'yan	立眉瞪眼。形容醉态。
瞪目哆口	deng'mu'duo'kou	睁大眼睛，张开嘴巴。形容惊呆之貌。
瞪目结舌	deng'mu'jie'she	睁着眼睛，说不出话来。形容神情紧张或很吃惊。
瞪眼咋舌	deng'yan'zha'she	见“瞪目结舌”。
低唱浅斟	di'chang'qian'zhen	谓听人曼声歌唱，并自在地缓缓饮酒。形容一种安乐自适的情态。语出《绿窗新话》卷二引宋无名氏《湘江近事》：“陶穀学士，尝买得党太尉家故妓。过定陶，取雪水烹团茶，谓妓曰：‘党太尉家应不识此。’妓曰：‘彼粗人也，安有此景，但能销金暖帐下，浅斟低唱，饮羊羔美酒耳。’穀愧其言。”
低眉垂眼	di'mei'chui'yan	害羞貌。
低眉顺眼	di'mei'shun'yan	驯良恭顺貌。
低情曲意	di'qing'qu'yi	谓对不住，不得已。
低三下四	di'san'xia'si	①形容社会地位低下。②形容卑贱恭顺，阿谀逢迎。
低声细语	di'sheng'xi'yu	形容小声说话。
低声下气	di'sheng'xia'qi	形容恭顺小心的样子。
低声哑气	di'sheng'ya'qi	又作：低声下气。
低首下心	di'shou'xia'xin	形容屈服顺从。
低头耷脑	di'tou'da'nao	形容惶恐或无精打彩的样子。
低头搭脑	di'tou'da'nao	见“低头耷脑”。
低头哈腰	di'tou'ha'yao	谦卑恭顺貌。
低头丧气	di'tou'sang'qi	失意颓丧貌。
低心下意	di'xin'xia'yi	谓小心谨慎、专注不移。
羝羊触籓	di'yang'chu'fan	公羊角钩在篱笆上。比喻进退两难。
隄溃蚁孔	di'kui'yi'kong	《韩非子·喻老》：“千丈之隄，以蝼蚁之穴溃。”后因以“隄溃蚁孔”比喻小处疏忽，会酿成大祸。
滴露研珠	di'lu'yan'zhu	指滴水磨墨。
滴露研硃	di'lu'yan'zhu	亦作“滴露研硃”。滴水研磨硃砂。指用硃笔评校书籍。
滴露研硃	di'lu'yan'zhu	见“滴露研珠”。
滴露研硃	di'lu'yan'zhu	见“滴露研珠”。
滴水不羼	di'shui'bu'chan	形容十分纯正。
滴水不漏	di'shui'bu'lou	比喻严密。
滴水成冰	di'shui'cheng'bing	形容气候十分寒冷。
滴水成河	di'shui'cheng'he	比喻积少成多。
滴水穿石	di'shui'chuan'shi	喻坚持不懈则事必有成。
滴水难消	di'shui'nan'xiao	谓虽菲薄之物也不能受用。
敌不可假	di'bu'ke'jia	谓不可宽容敌人。
敌不可纵	di'bu'ke'zong	对敌人不能放纵。
敌国通舟	di'guo'tong'zhou	同船的人都成了敌人。比喻众叛亲离。
敌国外患	di'guo'wai'huan	指来自敌对国家的侵略骚扰。
敌惠敌怨	di'hui'di'yuan	又作：报德报怨。
敌忾同仇	di'kai'tong'chou	《诗·秦风·无衣》：“修我戈矛，与子同仇”。《左传·文公四年》：“诸侯敌王所忾，而献其功”。杜预注：“敌，犹当也；忾，恨怒也”。后以“敌忾同仇”指抱着无比仇恨和愤怒共同一致地对付敌人。
敌力角气	di'li'jiao'qi	以力气相斗。
敌王所忾	di'wang'suo'kai	谓把天子所痛恨的人作为自己的敌人而加以讨伐。
涤地无类	di'di'wu'lei	荡涤无遗。形容清除得彻底。
涤故更新	di'gu'geng'xin	清除旧的，改换新的。
涤秽布新	di'hui'bu'xin	清除陈旧的，建立新的。
涤秽荡瑕	di'hui'dang'xia	同“涤瑕荡秽”。
涤瑕荡垢	di'xia'dang'gou	见“涤瑕荡秽”。
涤瑕荡秽	di'xia'dang'hui	清除缺点过失；清除污泥浊水。
底死谩生	di'si'man'sheng	竭尽全力，想尽办法。底，通“抵”。
抵死瞒生	di'si'man'sheng	见“抵死漫生”。
抵死谩生	di'si'man'sheng	见“抵死漫生”。
抵死漫生	di'si'man'sheng	又作：竭尽思虑；千方百计。
砥锋挺锷	di'feng'ting'e	磨刀拔剑。谓以武力反抗。
砥节厉行	di'jie'li'xing	见“砥节励行”。
砥节励行	di'jie'li'xing	砥砺操守和品行。
砥节砺行	di'jie'li'xing	见“砥节励行”。
砥厉廉隅	di'li'lian'yu	谓磨练节操。廉隅，棱角，喻指方正的操守。
砥厉名号	di'li'ming'hao	见“砥砺名号”。
砥砺廉隅	di'li'lian'yu	见“砥厉廉隅”。
砥砺名号	di'li'ming'hao	亦作“砥厉名号”。谓自修品节，以保令名。
砥砺名节	di'li'ming'jie	砥砺磨练，立名立节。
砥廉峻隅	di'lian'jun'yu	经过磨砺，使棱角更加分明。
砥身砺行	di'shen'li'xing	又作：砥节砺行。
砥志研思	di'zhi'yan'si	专心致志，深思钻研。
砥柱中流	di'zhu'zhong'liu	砥柱山屹立在黄河急流之中。比喻能负重任，支危局。
地北天南	di'bei'tian'nan	谓四处，到处。
地丑德齐	di'chou'de'qi	土地相似，德教齐等。谓彼此不相上下。
地丑力敌	di'chou'li'di	谓土地相似，力量相当。
地大物博	di'da'wu'bo	谓国家疆土辽阔，物产丰富。
地动山摧	di'dong'shan'cui	见“地动山摇”。
地负海涵	di'fu'hai'han	谓大地负载万物，海洋容纳百川。形容包罗万象，含蕴丰富。语本唐韩愈《南阳樊绍述墓志铭》：“其富若生蓄，万物必具，海含地负，放恣横从，无所统纪。”语本唐韩愈《南阳樊绍述墓志铭》：“其富若生蓄，万物必具，海含地负，放恣横从，无所统纪。”
地覆天翻	di'fu'tian'fan	形容变化巨大。
地广人希	di'guang'ren'xi	见“地广人稀”。
地广人稀	di'guang'ren'xi	亦作“地广人希”。亦作“地旷人稀”。谓土地广大，人烟稀少。
地棘天荆	di'ji'tian'jing	谓到处布满荆棘。比喻环境恶劣。
地瘠民贫	di'ji'min'pin	土地瘠薄，人民贫穷。
地角天涯	di'jiao'tian'ya	形容极远的地方或彼此相隔很远。
地久天长	di'jiu'tian'chang	①形容历时悠久。②形容爱情永久不变。又作：白头到老。
地旷人稀	di'kuang'ren'xi	见“地广人稀”。
地老天荒	di'lao'tian'huang	①形容经历的时间长久。②又作：地为之老，天为之荒。形容极其感人。③谓改朝换代。
地老天昏	di'lao'tian'hun	形容变化剧烈。
地灵人杰	di'ling'ren'jie	谓人物杰出，盖因地之灵秀。
地平天成	di'ping'tian'cheng	比喻上下相称，万事妥帖。
地上天宫	di'shang'tian'gong	比喻富庶华美的地方。
地塌天荒	di'ta'tian'huang	又作：天塌地陷。形容盛怒。
地下修文	di'xia'xiu'wen	据晋王隐《晋书》载，中牟令苏韶死后现形，对其堂弟苏节说，颜渊、卜商现为地下修文郎；修文郎凡八人，皆鬼之圣者。韶今亦守其职。见《太平御览》卷八八三引。后因以“地下修文”为文士死亡的典故。
地主之仪	di'zhu'zhi'yi	见“地主之谊”。
地主之谊	di'zhu'zhi'yi	《左传·哀公十二年》：“子服景伯谓子财曰：‘夫诸侯之会，事既毕矣，侯伯致礼，地主归饩，以相辞也。’”杜预注：“侯伯致礼以礼宾也。地主，所会主人也。饩，生物。”孔颖达疏：“致礼礼宾，当谓有以礼之，或设饮食与之宴也。”后因以“地主之谊”谓当地的主人对来客接待的礼节和饮食馈赠等情谊。
弟男子侄	di'nan'zi'zhi	泛指晚辈男子。
帝辇之下	di'nian'zhi'xia	皇帝所在的地方。用指京都。
递胜递负	di'sheng'di'fu	谓胜负交替。
递兴递废	di'xing'di'fei	谓有兴有废。
谛分审布	di'fen'shen'bu	仔细察看分布状况。
掂斤播两	dian'jin'bo'liang	估量轻重。亦以喻品评优劣或形容过分计较。
掂斤估两	dian'jin'gu'liang	又作：掂斤播两。
掂斤抹两	dian'jin'mo'liang	又作：掂斤播两。
掂梢折本	dian'shao'zhe'ben	垫钱亏本。梢，钱的市语。
颠簸不破	dian'bo'bu'po	同“颠扑不破”。
颠脣簸嘴	dian'chun'bo'zui	谓搬弄口舌。
颠倒黑白	dian'dao'hei'bai	语本《楚辞·九章·怀沙》：“变白以为黑兮，倒上以为下。”王逸注：“世以浊为清也；俗人以愚为贤也。”后世多作“颠倒黑白”，形容故意歪曲事实，混淆是非。
颠倒是非	dian'dao'shi'fei	把对的说成错的，把错的说成对的。
颠倒衣裳	dian'dao'yi'chang	①谓急促惶遽中不暇整衣。《诗·齐风·东方未明》：“东方未明，颠倒衣裳。颠之倒之，自公召之。”毛传：“上曰衣，下曰裳。”郑玄笺：“絜壶氏失漏刻之节，东方未明而以为明，故群臣促遽颠倒衣裳。”孔颖达疏：“传：上曰衣，下曰裳。此其相对定称，散则通名曰衣……传言此，解其颠倒之意，以裳为衣，今上者在下，是谓颠倒也。”本意是讽刺朝廷兴居无节，号令不时，使小官吏忙忙碌碌，后多以比喻伦常失秩。②谓匆忙情急之中举止失措。
颠斤播两	dian'jin'bo'liang	较量轻重。常用以比喻品评优劣或形容计较微细之事。
颠来播去	dian'lai'bo'qu	见“颠来簸去”。
颠来簸去	dian'lai'bo'qu	连续、反覆地颠簸。
颠来倒去	dian'lai'dao'qu	翻过来倒过去。来回重复。
颠鸾倒凤	dian'luan'dao'feng	①比喻颠倒失次。②比喻男女交欢。
颠毛种种	dian'mao'zhong'zhong	语本《左传·昭公三年》：“余发如此种种，余奚能为？”杜预注：“种种，短也。自言衰老，不能复为害。”后因以“颠毛种种”谓衰老。
颠沛流离	dian'pei'liu'li	动荡不安，四处流浪，困顿窘迫。
颠仆流离	dian'pu'liu'li	同“颠沛流离”。
颠扑不磨	dian'pu'bu'mo	见“颠扑不破”。
颠扑不破	dian'pu'bu'po	无论怎样摔打都不破。比喻言论、学说牢固可靠，不可推翻、驳倒。
颠乾倒坤	dian'qian'dao'kun	使天地颠倒。比喻本领十分高强。
颠三倒四	dian'san'dao'si	形容神智不清或说话、做事没有次序，错误百出。
颠衣到裳	dian'yi'dao'chang	同“颠倒衣裳”。到，通“倒”。
攧扑不破	dian'pu'bu'po	无论怎样摔打都不破。比喻道理正确，推翻不了。
典谟训诰	dian'mo'xun'gao	①《尚书》中《尧典》、《大禹谟》、《汤诰》、《伊训》等篇的并称。②泛指经典之文。
典妻鬻子	dian'qi'yu'zi	典卖妻子兒女。形容生活极其困苦。
典身卖命	dian'shen'mai'ming	典当身体，出卖性命。极言奉献出自己的一切。
典则俊雅	dian'ze'jun'ya	端庄高雅而标致。
点金成铁	dian'jin'cheng'tie	①禅门喻开示不对机，增人惑乱。《景德传灯录·真觉大师灵照》：“问：‘还丹一粒，点铁成金；至理一言，点凡成圣。请师一点。’师曰：‘还知齐云点金成铁吗？’曰：‘点金成铁，未之前闻。至理一言，敢希垂示！’”后用以比喻把好文章改坏。②比喻把好事办坏。
点金乏术	dian'jin'fa'shu	谓无点金成铁的法术。比喻没有办法筹措钱财。
点金无术	dian'jin'wu'shu	见“点金乏术”。
点金作铁	dian'jin'zuo'tie	见“点金成铁”。
点石成金	dian'shi'cheng'jin	同“点铁成金”。
点石为金	dian'shi'wei'jin	同“点铁成金”。
点手莋脚	dian'shou'zuo'jiao	形容说话时兼用手势示意。多形容说话放任不拘，或轻率地指点、批评。
点水不漏	dian'shui'bu'lou	形容十分周到、严密，毫无差失漏洞。
点铁成金	dian'tie'cheng'jin	①旧谓仙道点铁石而成黄金。②比喻修改文章，化腐朽为神奇。
点头哈腰	dian'tou'ha'yao	形容恭顺或过分客气。
点头会意	dian'tou'hui'yi	①形容机灵乖觉。②表示允可、赞许。
点头咂嘴	dian'tou'za'zui	表示同意、赞赏。
点头之交	dian'tou'zhi'jiao	谓交情甚浅，见了面只不过点点头而已。
点胸洗眼	dian'xiong'xi'yan	指一洗尘俗，使人豁然明朗。
点纸画字	dian'zhi'hua'zi	指在契约或供词上捺指模和签押。
点指画字	dian'zhi'hua'zi	指在合同文约或供词上按手印签字画押。
点指莋脚	dian'zhi'zuo'jiao	见“点手莋脚”。
电掣风驰	dian'che'feng'chi	形容像闪电刮风一样迅速。
电掣星驰	dian'che'xing'chi	如闪电和流星似的掠过。比喻迅疾。
电光石火	dian'guang'shi'huo	①佛教语。语本《五灯会元·雪峰存禅师法嗣·保福从展禅师》：“师曰：‘瞌睡汉出去！’上堂：‘此事如击石火，似闪电光，搆得搆不得，未免丧身失命。’”后以“电光石火”比喻稍纵即逝或稍纵即逝的事物。②喻极迅速地。
电流星散	dian'liu'xing'san	比喻迅速消散。
电闪雷鸣	dian'shan'lei'ming	闪电飞光，雷声轰鸣。①比喻快速有力。杜鹏程《在和平的日子里》第五章：“是英明的主意，这主意通过电话就电闪雷鸣一样传遍工地。”②比喻轰轰烈烈。郭小川《痛悼敬爱的周总理》诗：“我们的总理，回答得最为铿锵有力；不用语言，而用电闪雷鸣般的一生的经历。”
电照风行	dian'zhao'feng'xing	如电光之照耀，如风之流动。比喻影响甚大。
钿合金钗	dian'he'jin'chai	①钿盒和金钗。相传为唐玄宗与杨贵妃定情之信物。②泛指情人间之信物。
刁钻促搯	diao'zuan'cu'tao	见“刁钻促狭”。
刁钻促狭	diao'zuan'cu'xia	亦作“刁钻促搯”。狡猾而好捉弄人。
刁钻古怪	diao'zuan'gu'guai	①狡诈。②古怪，怪僻。③机灵，乖巧。
彫蟲小技	diao'chong'xiao'ji	指刻意雕琢词章的微小技能。
彫蟲小技	diao'chong'xiao'ji	指刻意雕琢词章的微小技能。
彫蟲篆刻	diao'chong'zhuan'ke	虫书、刻符分别为秦书八体之一，西汉时蒙童所习。因以“彫蟲篆刻”喻词章小技。
彫蟲篆刻	diao'chong'zhuan'ke	虫书、刻符分别为秦书八体之一，西汉时蒙童所习。因以“彫蟲篆刻”喻词章小技。
彫肝琢肾	diao'gan'zhuo'shen	形容苦心琢磨。
彫肝琢肾	diao'gan'zhuo'shen	形容苦心琢磨。
彫章镂句	diao'zhang'lou'ju	谓刻意雕琢词章。
彫章镂句	diao'zhang'lou'ju	谓刻意雕琢词章。
貂不足，狗尾续	diao'bu'zu'-'gou'wei'xu	续】	①谓授官太滥。②指美中不足或以次充好。
貂狗相属	diao'gou'xiang'shu	指真伪或优劣混杂在一起。
貂裘换酒	diao'qiu'huan'jiu	《西京杂记》卷二载，司马相如与卓文君还成都，以所著鹔霜裘向市人贳酒。又《晋书·阮孚传》谓阮孚尝以金貂换酒。后世即以“貂裘换酒”形容名士或富贵者的风流豪纵。
雕蟲薄技	diao'chong'bao'ji	又作：雕虫小技。
雕蟲刻篆	diao'chong'ke'zhuan	见“雕蟲篆刻”。
雕蟲末伎	diao'chong'mo'ji	见“雕蟲末技”。
雕蟲末技	diao'chong'mo'ji	亦作“雕蟲末伎”。又作：雕虫小技。
雕蟲小技	diao'chong'xiao'ji	比喻微末的技能。多指刻意雕琢词章的技能。
雕蟲小巧	diao'chong'xiao'qiao	又作：雕虫小技。
雕蟲小事	diao'chong'xiao'shi	又作：雕虫小技。
雕蟲小艺	diao'chong'xiao'yi	又作：雕虫小技。
雕蟲篆刻	diao'chong'zhuan'ke	汉扬雄《法言·吾子》：“或问：‘吾子少而好赋？’曰：‘然。童子雕蟲篆刻。’俄而曰；‘壮夫不为也。’”按，“蟲”指虫书，“刻”指刻符，各为一种字体。后以“雕蟲篆刻”喻词章小技。南朝梁沈约《答陆厥问声韵书》：“是以子云譬之雕蟲篆刻，云壮夫不为。”宋王安石《上仁宗皇帝言事书》：“然而不肖者，苟能雕蟲篆刻之学，以此进至乎公卿。”况周颐《蕙风词话》卷五：“適承元明词敝甚，欲推尊斯道，一洗雕蟲篆刻之讥。”亦作“雕蟲刻篆”。明高濂《玉簪记·下第》：“不须泪涟。有日眉扬额点，且自雕蟲刻篆，我这里侭清閒。”一说，“雕蟲”犹“蟲镂”（“彤镂”），“篆刻”犹“瑑刻”。参阅蒋礼鸿《义府续貂》。
雕风镂月	diao'feng'lou'yue	刻意吟风弄月。
雕肝镂肾	diao'gan'lou'shen	同“雕肝琢肾”。
雕肝掐肾	diao'gan'qia'shen	同“雕肝琢肾”。
雕肝琢膂	diao'gan'zhuo'lv	同“雕肝琢肾”。
雕肝琢肾	diao'gan'zhuo'shen	比喻写作时用尽心思，反覆推敲，刻意求工。语本唐韩愈《赠崔立之评事》诗：“劝君韬养待徵招，不用雕琢愁肝肾。”
雕虎焦原	diao'hu'jiao'yuan	《尸子》：“中黄伯曰：余左执太行之獶而右搏雕虎。”又：“莒国有石焦原者，广寻，长五十步，临百仞之谿，莒国莫敢近也。有以勇见莒子者，独却行剂踵焉。”后以“雕虎焦原”谓壮士履险。
雕梁画栋	diao'liang'hua'dong	雕花、彩绘的栋梁。亦借指有彩绘装饰的富丽堂皇的房屋。
雕龙画凤	diao'long'hua'feng	刻绘龙凤；刻绘的龙凤。
雕镂藻绘	diao'lou'zao'hui	比喻刻意修饰文辞。
雕盘绮食	diao'pan'qi'shi	精美的器皿及食物。
雕墙峻宇	diao'qiang'jun'yu	同“峻宇雕墙”。
雕文刻镂	diao'wen'ke'lou	谓在器物上刻镂花纹图案，以为文饰。
雕文织采	diao'wen'zhi'cai	比喻词藻华丽。
雕心刻肾	diao'xin'ke'shen	同“雕肝琢肾”。
雕心雁爪	diao'xin'yan'zhao	见“雕心雁爪”。
雕心雁爪	diao'xin'yan'zhao	比喻外表善良而内心狠毒。
雕心鹰爪	diao'xin'ying'zhao	喻凶残狠毒。
雕心鹰爪	diao'xin'ying'zhao	比喻心肠残忍，手段毒辣。
雕楹碧槛	diao'ying'bi'jian	雕镂彩绘的柱子和碧色栏杆。
雕章绘句	diao'zhang'hui'ju	见“雕章镂句”。
雕章镂句	diao'zhang'lou'ju	比喻刻意修饰文辞。
雕章缛彩	diao'zhang'ru'cai	比喻文彩绚烂。
雕章琢句	diao'zhang'zhuo'ju	见“雕章镂句”。
吊胆惊心	diao'dan'jing'xin	又作：吊胆提心。
吊民伐罪	diao'min'fa'zui	慰问受害的百姓，讨伐有罪的人。
吊死扶伤	diao'si'fu'shang	吊祭死者，扶救伤者。
吊死问疾	diao'si'wen'ji	吊祭死者，慰问病人。
吊形吊影	diao'xing'diao'ying	又作：形影相吊。喻孤独寂寞。
钓名沽誉	diao'ming'gu'yu	同“沽名钓誉”。
钓名欺世	diao'ming'qi'shi	作伪求取虚名，欺骗世人。
钓名要誉	diao'ming'yao'yu	见“钓名沽誉”。
钓誉沽名	diao'yu'gu'ming	见“钓名沽誉”。
调兵遣将	diao'bing'qian'jiang	调动兵马，派遣将领。引申为调动布置人力。
调脣弄舌	diao'chun'nong'she	见“调脣弄舌”。
调脣弄舌	diao'chun'nong'she	亦作“调脣弄舌”。①耍嘴皮子，纵谈。②搬弄是非。
调脣弄舌	diao'chun'nong'she	亦作“调脣弄舌”。①耍嘴皮子，纵谈。②搬弄是非。
调词架讼	diao'ci'jia'song	调唆他人诉讼。
调风变俗	diao'feng'bian'su	又作：移风易俗。
调风弄月	diao'feng'nong'yue	调弄风月。喻男女间的谈情说爱。
调和鼎鼐	diao'he'ding'nai	调和五味。喻指宰相治理天下。
调和阴阳	diao'he'yin'yang	谓使阴阳有序，风调雨顺。旧多指宰相处理政务。
调虎离山	diao'hu'li'shan	比喻为了便于乘机行事，设法引诱对方离开原来的地方。
调理阴阳	diao'li'yin'yang	又作：调和阴阳。
调良稳泛	diao'liang'wen'fan	马匹调良，行船稳泛。谓路途平安。
调墨弄笔	diao'mo'nong'bi	谓玩弄文字技巧。
调三惑四	diao'san'huo'si	见“调三斡四”。
调三窝四	diao'san'wo'si	见“调三斡四”。
调三斡四	diao'san'wo'si	挑拨是非。
调舌弄脣	diao'she'nong'chun	又作：调脣弄舌。
调神暢情	diao'shen'chang'qing	使精神顺适，情绪欢暢。
调丝品竹	diao'si'pin'zhu	吹弹乐器。
调停两用	diao'ting'liang'yong	谓居间观望，骑墙投机。
调脂弄粉	diao'zhi'nong'fen	①指妇女涂抹脂粉，整容打扮。②喻指诗文的富丽香艳。
调硃傅粉	diao'zhu'fu'fen	调弄、涂抹脂粉。喻刻意修饰。
调硃弄粉	diao'zhu'nong'fen	调弄脂粉，打扮妆饰。
调嘴调舌	diao'zui'diao'she	见“调嘴弄舌”。
调嘴弄舌	diao'zui'nong'she	耍嘴皮子，搬弄是非。
调嘴学舌	diao'zui'xue'she	又作：调嘴弄舌。
掉以轻心	diao'yi'qing'xin	轻率，不重视。语本唐柳完元《答韦中立论师道书》：“故吾每为文章，未尝敢以轻心掉之。”
跌弹斑鸠	die'dan'ban'jiu	谓中弹落地的斑鸠。喻指失意落寞或受挫神伤的人。
跌宕不覊	die'dang'bu'ji	见“跌宕不羁”。
跌宕不羁	die'dang'bu'ji	放逸不受拘束。
跌宕风流	die'dang'feng'liu	潇洒放逸而富有才华风情。
跌宕昭彰	die'dang'zhao'zhang	谓文章的气势纵放不拘，文意鲜明。
跌荡不羁	die'dang'bu'ji	同“跌宕不羁”。
跌荡不拘	die'dang'bu'ju	见“跌荡不羁”。
跌荡风流	die'dang'feng'liu	见“跌宕风流”。
跌脚绊手	die'jiao'ban'shou	谓受到阻碍或牵制。
跌脚捶胸	die'jiao'chui'xiong	见“跌脚搥胸”。
跌脚搥胸	die'jiao'chui'xiong	以足跺地，以拳敲胸。表示气愤、着急、悲痛等感情。
跌脚槌胸	die'jiao'chui'xiong	见“跌脚搥胸”。
喋喋不休	die'die'bu'xiu	唠唠叨叨，说个没完。
叠床架屋	die'chuang'jia'wu	①北齐颜之推《颜氏家训·序致》：“魏晋已来，所著诸子，理重事衤复，递相模斅，犹屋下架屋，床上施床耳。”宋陆九渊《与硃元晦书》之二：“某窃谓尊兄未曾实见太极，若实见太极，上面必不更加‘无极’字，下面必不更着‘真体’字。上面加‘无极’字，正是叠床上之床，下面着‘真体’字，正是架屋下之屋。”后以“叠床架屋”比喻重复累赘。②比喻反复强调。
叠见层出	die'jian'ceng'chu	屡次出现。
叠矩重规	die'ju'zhong'gui	形容上下相合。矩，曲尺，画直角或方形的工具。规，圆规，画圆形的工具。
蝶粉蜂黄	die'fen'feng'huang	唐人宫妆。宋周邦彦《满江红》词：“蝶粉蜂黄都褪了，枕痕一线红生肉。”一说蝶翅上的粉屑和蜂身上的黄粉，在交尾后退去。
蝶化庄生	die'hua'zhuang'sheng	比喻事物的虚幻无常。
蝶化庄周	die'hua'zhuang'zhou	见“蝶化庄生”。
蝶恋蜂狂	die'lian'feng'kuang	谓留恋繁花似锦的春光。
蝶使蜂媒	die'shi'feng'mei	比喻传递信息者或男女双方情爱的媒介。
蝶意莺情	die'yi'ying'qing	比喻爱恋春色的情意。
蝶怨蛩凄	die'yuan'qiong'qi	喻哀怨凄清的思家之情。
蹀躞不下	die'xie'bu'xia	谓心里忐忑不安，不能放心。
鰈离鹣背	die'li'jian'bei	喻夫妻或恋人分离。
丁公凿井	ding'gong'zao'jing	春秋时，宋人丁某家中无井，常派一人出外汲水，后来家中挖了井，不须外出挑水，节省一人力，于是对人说：“吾穿井得一人。”听者误传成从井中挖得一人。见《吕氏春秋·察传》。汉王充《论衡·书虚》：“俗传言曰，丁公凿井，得一人於井中。夫人生於人，非生於土也。”后用以喻语言之辗转传误。
丁一卯二	ding'yi'mao'er	①确实；实在。②谓认真；仔细。
丁一确二	ding'yi'que'er	明白；确实。
钉嘴铁舌	ding'zui'tie'she	形容嘴哽，嘴犟。
顶礼膜拜	ding'li'mo'bai	①谓虔诚地跪拜。是佛教徒拜佛时的最敬礼。②形容崇拜得五体投地。
顶门立户	ding'men'li'hu	支撑门户。谓独立成家。
顶门壮户	ding'men'zhuang'hu	谓支撑门户，光耀门第。
顶名冒姓	ding'ming'mao'xing	谓冒充他人。
顶名替身	ding'ming'ti'shen	又作：顶名冒姓。
顶天立地	ding'tian'li'di	①头顶青天，脚踏大地。谓生存于天地间。②形容身躯魁伟。③形容堂堂正正，志向远大，气概不凡。
顶天踵地	ding'tian'zhong'di	又作：顶天立地。
顶踵尽捐	ding'zhong'jin'juan	又作：顶踵捐糜。
顶踵捐糜	ding'zhong'juan'mi	谓捐躯，牺牲。
鼎铛玉石	ding'dang'yu'shi	谓视鼎如铛，视玉如石。形容奢侈。
鼎成龙去	ding'cheng'long'qu	《史记·封禅书》：“黄帝采首山铜，铸鼎於荆山下。鼎既成，有龙垂胡曈下迎黄帝。黄帝上骑，群臣后宫从上者七十馀人，龙乃上去。”后以“鼎成龙去”指帝王去世。
鼎成龙升	ding'cheng'long'sheng	见“鼎成龙去”。
鼎鼎大名	ding'ding'da'ming	形容名声极大。
鼎鼎有名	ding'ding'you'ming	见“鼎鼎大名”。
鼎分三足	ding'fen'san'zu	见“鼎足三分”。
鼎湖龙去	ding'hu'long'qu	同“鼎成龙去”。
鼎镬刀锯	ding'huo'dao'ju	古代四种酷刑的刑具。泛指最残酷的刑罚。
鼎鼐调和	ding'nai'diao'he	相传商武丁问傅说治国之方，傅以如何调和鼎中之味喻说，遂辅武丁以治国。后因以“鼎鼐调和”比喻处理国政。
鼎食鸣钟	ding'shi'ming'zhong	亦作“鼎食鸣锺”。击钟列鼎而食。形容富贵人家生活豪侈。
鼎食鸣锺	ding'shi'ming'zhong	见“鼎食鸣钟”。
鼎新革故	ding'xin'ge'gu	《易·杂卦》：“革，去故也；鼎，取新也。”旧时多以“鼎新革故”指朝政变革或改朝换代。后泛指事物的破旧立新。
鼎鱼幕燕	ding'yu'mu'yan	《文选·丘迟〈与陈伯之书〉》：“而将军鱼游於沸鼎之中，燕巢於飞幕之上，不亦惑乎。”李善注：“袁崧《后汉书》：‘硃穆上疏曰：养鱼沸鼎之中，栖鸟烈火之上，用之不时，必也燋烂。’《左氏传》曰：‘吴季札曰：夫子之在此也，犹燕巢于幕之上。’”后以“鼎鱼幕燕”比喻处于极危险境地的人或事物。
鼎玉龟符	ding'yu'gui'fu	旧指传国之宝及受命之符箓。
鼎折覆餗	ding'zhe'fu'su	《易·鼎》：“九四，鼎折足，覆公餗，其形渥，凶。”孔颖达疏：“施之於人，知小而谋大，力薄而任重，如此必受其至辱，灾及其身也，故曰其形渥，凶。”后以“鼎折覆餗”比喻力薄任重，必致灾祸。
鼎折餗覆	ding'zhe'su'fu	见“鼎折覆餗”。
鼎足而立	ding'zu'er'li	像鼎的三只脚一样，三者各立一方。常比喻三方面分立相持的局面。
鼎足而三	ding'zu'er'san	谓像鼎足一样，三方面并立。
鼎足三分	ding'zu'san'fen	如鼎之三足，各据一方。比喻三方面分立相持的局势。
鼎足之势	ding'zu'zhi'shi	比喻三方面分立相持的局势。
丢魂丢魄	diu'hun'diu'po	见“丢魂失魄”。
丢魂丧胆	diu'hun'sang'dan	形容非常惊慌。
丢魂失魄	diu'hun'shi'po	①形容非常惊慌。②谓没头脑，无主见。
丢盔抛甲	diu'kui'pao'jia	见“丢盔卸甲”。
丢盔弃甲	diu'kui'qi'jia	见“丢盔卸甲”。
丢盔卸甲	diu'kui'xie'jia	形容打了大败仗时的狼狈相。亦比喻事情的失败。
丢人现眼	diu'ren'xian'yan	丢脸；出丑。
丢三拉四	diu'san'la'si	见“丢三落四”。
丢三落四	diu'san'luo'si	形容马虎或记忆力不好而顾此失彼。
丢三忘四	diu'san'wang'si	见“丢三落四”。
丢卒保车	diu'zu'bao'che	原为棋术用语。后多用以比喻丢掉次要的，保住主要的。
东挨西撞	dong'ai'xi'zhuang	同“东奔西撞”。
东捱西问	dong'ai'xi'wen	谓四处探问、打听。
东奔西窜	dong'ben'xi'cuan	同“东逃西窜”。
东奔西跑	dong'ben'xi'pao	同“东奔西走”。
东奔西逃	dong'ben'xi'tao	同“东逃西窜”。
东奔西向	dong'ben'xi'xiang	谓各奔东西，互不相关。
东奔西撞	dong'ben'xi'zhuang	形容无固定目标，到处乱闯。
东奔西走	dong'ben'xi'zou	谓到处奔波。
东播西流	dong'bo'xi'liu	谓流落四方。
东补西凑	dong'bu'xi'cou	同“东挪西凑”。
东猜西揣	dong'cai'xi'chuai	谓多方猜测。
东猜西疑	dong'cai'xi'yi	谓胡乱猜疑。
东藏西躲	dong'cang'xi'duo	见“东躲西藏”。
东差西误	dong'cha'xi'wu	谓出现这样或那样的差池、错误。形容办事不得力。
东抄西袭	dong'chao'xi'xi	胡乱抄袭别人的文章。
东扯西拉	dong'che'xi'la	形容说话离题，没有中心。
东扯西拽	dong'che'xi'zhuai	①谓事情互相纠缠。②又作：拆东补西。
东闯西踱	dong'chuang'xi'duo	谓盲目地四处闯荡。
东驰西骋	dong'chi'xi'cheng	同“东奔西走”。
东驰西击	dong'chi'xi'ji	谓指挥不统一，几路军队各自行动。
东驰西撞	dong'chi'xi'zhuang	同“东奔西撞”。
东冲西决	dong'chong'xi'jue	形容洪水四处冲决泛滥。
东冲西突	dong'chong'xi'tu	谓四处冲锋突击。
东冲西撞	dong'chong'xi'zhuang	谓无把握地四处奔走寻找。
东穿西撞	dong'chuan'xi'zhuang	同“东奔西撞”。
东窗计	dong'chuang'ji	谋害忠良的阴谋诡计。
东窗事发	dong'chuang'shi'fa	据明田汝成《西湖游览志馀·佞倖盘荒》载，宋元间传说，秦桧欲杀岳飞时，曾与妻子王氏在东窗下密谋。后桧游西湖，舟中得疾，见一人披发厉声曰：“汝误国害民，吾已诉天，得请矣。”桧死后，在地狱备受诸苦。王氏给他做道场，并派道士去探望他，他对道士说：“可烦传语夫人，东窗事发矣。”后因以“东窗事发”或“东窗事犯”概指此事。亦用以喻阴谋败露，自食恶果。
东窗事犯	dong'chuang'shi'fan	见“东窗事发”。
东窗消息	dong'chuang'xiao'xi	见“东窗计”。
东床佳婿	dong'chuang'jia'xu	同“东床娇婿”。
东床姣婿	dong'chuang'jiao'xu	同“东床娇婿”。
东床娇客	dong'chuang'jiao'ke	同“东床娇婿”。
东床娇婿	dong'chuang'jiao'xu	对女婿的美称。
东床坦腹	dong'chuang'tan'fu	南朝宋刘义庆《世说新语·雅量》：“郄太傅在京口，遣门生与王丞相书，求女壻。丞相语郄信：‘君往东厢，任意选之。’门生归白郄曰：‘王家诸郎亦皆可嘉。闻来觅壻，咸自矜持；唯有一郎在东床上坦腹卧，如不闻。’郄公云：‘正此好！’访之，乃是逸少，因嫁女与焉。”按，《晋书·王羲之传》述此事，作“惟一人在东床坦腹食”。后因以“东床坦腹”代指女婿。
东床择对	dong'chuang'ze'dui	谓择婿。
东床之选	dong'chuang'zhi'xuan	谓佳婿的人选。
东荡西驰	dong'dang'xi'chi	又作：东征西讨。
东荡西除	dong'dang'xi'chu	又作：东征西讨。
东倒西歪	dong'dao'xi'wai	①形容身不由己，倾斜不稳。②有的倒，有的歪。形容建筑物等破旧不牢固。
东道主	dong'dao'zhu	秋时，晋秦合兵围郑，郑文公使烛之武说秦穆公，曰：“若舍郑以为东道主，行李之往来，共其乏困，君亦无所害。”事见《左传·僖公三十年》。郑在秦东，接待秦国出使东方的使节，故称“东道主”。后因以泛指接待或宴客的主人。
东道主人	dong'dao'zhu'ren	见“东道主”。
东躲西藏	dong'duo'xi'cang	谓到处躲避藏匿。
东方不亮西方亮	dong'fang'bu'liang'xi'fang'liang	亮】	比喻这里行不通，别的地方尚有回旋余地。
东方千骑	dong'fang'qian'qi	①《玉台新咏·古乐府〈日出东南隅行〉》：“东方千馀骑，夫壻居上头。”本为诗中女主人公罗敷夸其夫婿显贵出众之词，后因以“东方千骑”、“东方骑”指代新婿。②泛指身分煊赫者。
东风吹马耳	dong'feng'chui'ma'er		见“东风射马耳”。
东风过耳	dong'feng'guo'er	见“东风射马耳”。
东风人面	dong'feng'ren'mian	谓一年一度的春风依旧，而当年邂逅含情之人却不得重见。有唐崔护《题都城南庄》诗典。
东风入律	dong'feng'ru'lv	谓春风和暢，律吕调协。常用以称颂盛世。
东风射马耳	dong'feng'she'ma'er		东风吹过马耳边。比喻充耳不闻，无动于衷。
东扶西倒	dong'fu'xi'dao	形容力不能支，扶不起来。
东滚西爬	dong'gun'xi'pa	形容溃逃时的狼狈相。
东郭先生	dong'guo'xian'sheng	小说《中山狼传》中的人物。其因救助被人追逐的中山狼，反而几乎被狼所害。后常用以比喻不分善恶，滥施仁慈的人。参阅明马中锡《中山狼传》。
东海鲸波	dong'hai'jing'bo	东海上的汹涌波涛。比喻来自东方的侵略。
东海捞针	dong'hai'lao'zhen	又作：大海捞针。形容极难达到目的。
东海逝波	dong'hai'shi'bo	东逝大海的波涛。比喻大势已去，无法挽回。
东海扬尘	dong'hai'yang'chen	晋葛洪《神仙传·麻姑》：“麻姑自说云：‘接侍以来，已见东海三为桑田。向到蓬莱，水又浅於往者会时略半也，岂将复还为陵陆乎？’方平笑曰：‘圣人皆言海中复扬尘也。’”后因以“东海扬尘”喻世事巨变。
东横西倒	dong'heng'xi'dao	形容杂乱。
东家西舍	dong'jia'xi'she	又作：左邻右舍。
东家效颦	dong'jia'xiao'pin	见“东施效颦”。
东箭南金	dong'jian'nan'jin	比喻优秀的人才。
东砍西斫	dong'kan'xi'zhuo	谓四面激战。
东磕西撞	dong'ke'xi'zhuang	又作：东奔西撞。
东诓西骗	dong'kuang'xi'pian	指到处说谎欺骗。
东拉西扯	dong'la'xi'che	①东凑一言，西凑一语。形容说话或写文章杂乱无章。②谓从各处拾取得来。
东来西去	dong'lai'xi'qu	谓行人来来往往。
东拦西阻	dong'lan'xi'zu	谓极力阻拦。
东捞西摸	dong'lao'xi'mo	谓盲目地四处求索。
东劳西燕	dong'lao'xi'yan	喻离别。劳，伯劳。鸟名。语本《乐府诗集·杂曲歌辞八·东飞伯劳歌》：“东飞伯劳西飞燕，黄姑织女时相见。”后亦以“东劳西燕”比喻来自不同方向的同路人。
东猎西渔	dong'lie'xi'yu	谓处处涉猎而不专精。
东邻西舍	dong'lin'xi'she	见“东家西舍”。
东鳞西爪	dong'lin'xi'zhao	谓画龙时，这边画片龙鳞，那边画只龙爪，只见一点，不见全身。比喻零碎，不全面。
东零西落	dong'ling'xi'luo	零散稀疏。形容衰败。
东零西散	dong'ling'xi'san	形容零落分散。
东零西碎	dong'ling'xi'sui	谓零碎，分散，不集中。
东流西落	dong'liu'xi'luo	见“东播西流”。
东门黄犬	dong'men'huang'quan	秦二世二年七月，丞相李斯因遭奸人诬陷，论腰斩咸阳市。临刑谓其中子曰：“吾欲与若复牵黄犬俱出上蔡东门逐狡兔，岂可得乎！”事见《史记·李斯列传》。后以“东门黄犬”作为官遭祸，抽身悔迟之典。
东门逐兔	dong'men'zhu'tu	见“东门黄犬”。
东鸣西应	dong'ming'xi'ying	谓各方面互有联系，互相影响。
东抹西涂	dong'mo'xi'tu	见“东涂西抹”。
东南之宝	dong'nan'zhi'bao	谓东南地区的杰出人才。
东南之美	dong'nan'zhi'mei	谓东南人物中之佼佼者。
东南之秀	dong'nan'zhi'xiu	谓东南地方的杰出人才。
东南竹箭	dong'nan'zhu'jian	《尔雅·释地》：“东南之美者，有会稽之竹箭焉。”后因以“东南竹箭”比喻优秀人才。
东挪西凑	dong'nuo'xi'cou	谓各处挪借，凑集款项。
东挪西撮	dong'nuo'xi'cuo	同“东挪西凑”。
东挪西借	dong'nuo'xi'jie	同“东挪西凑”。
东跑西颠	dong'pao'xi'dian	同“东奔西走”。
东碰西撞	dong'peng'xi'zhuang	同“东奔西撞”。
东飘西泊	dong'piao'xi'bo	谓四处漂泊，行踪无定。
东飘西荡	dong'piao'xi'dang	①谓不固定，没有着落。②谓无定向地漂浮。
东飘西徙	dong'piao'xi'xi	谓到处漂流，迁徙无定。
东拼西凑	dong'pin'xi'cou	①同“东挪西凑”。②谓从多方把零星事物拼凑在一起。
东迁西徙	dong'qian'xi'xi	谓四处迁移，居止不定。
东敲西逼	dong'qiao'xi'bi	各处敲诈逼迫。
东瞧西望	dong'qiao'xi'wang	同“东张西望”。
东趋西步	dong'qu'xi'bu	谓相背而行。
东山复起	dong'shan'fu'qi	同“东山再起”。
东山高卧	dong'shan'gao'wo	谓安然隐居。
东山再起	dong'shan'zai'qi	《晋书·谢安传》载：安少有重名，“初辟司徒府，除佐著作郎，并以疾辞。”隐居会稽东山，年逾四十复出为桓温司马，累迁中书令、司徒等要职，晋室赖以转危为安。后以“东山再起”指退隐复仕或失势后重新得势。
东山之志	dong'shan'zhi'zhi	指隐居的念头。
东闪西挪	dong'shan'xi'nuo	形容有所畏惧，躲躲闪闪。
东声西击	dong'sheng'xi'ji	又作：声东击西。扬言要攻此方，实际却攻彼方。
东施效颦	dong'shi'xiao'pin	《庄子·天运》：“故西施病心而矉其里，其里之丑人见而美之，归亦捧心而矉其里。其里之富人见之，坚闭门而不出；贫人见之，絜妻子而去之走。”成玄英疏：“西施，越之美女也，貌极妍丽。既病心痛，嚬眉苦之。而端正之人，体多宜便，因其嚬蹙，更益其美。是以闾里见之，弥加爱重。邻里丑人见而学之，不病强嚬，倍增其丑。”后因以“东施效颦”嘲讽不顾本身条件而一味模仿，以致效果很坏的人。亦为模仿别人的谦语。颦，同“矉”，蹙眉。
东食西宿	dong'shi'xi'su	《艺文类聚》卷四十引汉应劭《风俗通》：“齐人有女，二人求之。东家子丑而富，西家子好而贫。父母疑不能决，问其女，定所欲適……女云：‘欲东家食，西家宿。’”后因以“东食西宿”比喻贪得之人唯利是图。
东市朝衣	dong'shi'zhao'yi	汉景帝时，御史大夫晁错被谗，“衣朝衣斩东市。”事见《史记·吴王濞列传》、《汉书·晁错传》。后因以“东市朝衣”为朝臣被杀之典。
东搜西罗	dong'sou'xi'luo	到处寻找搜集。
东睃西望	dong'suo'xi'wang	同“东张西望”。
东谈西说	dong'tan'xi'shuo	谓议论的面很宽。
东逃西窜	dong'tao'xi'cuan	四处逃亡；四处逃避。
东讨西伐	dong'tao'xi'fa	同“东征西讨”。
东讨西征	dong'tao'xi'zheng	同“东征西讨”。
东偷西摸	dong'tou'xi'mo	谓暗中干不正当的事。
东投西窜	dong'tou'xi'cuan	同“东奔西走”。
东涂西抹	dong'tu'xi'mo	①谓妇女用脂粉打扮。②唐薛逢晚年宦途失意，曾策瘦马赴朝。值新科进士列队而出，前导责逢回避，逢笑，遣人答曰：“报道莫贫相！阿婆三五少年时，也曾东涂西抹来。”见五代王定保《唐摭言·慈恩寺题名游赏赋咏杂记》。本以妇女装饰为喻，谓自己少年时亦曾凭文章取进士。后用为自己写作或绘画的谦词。③胡写乱涂；轻率下笔。④比喻不从根本着手。
东兔西乌	dong'tu'xi'wu	谓月亮东升，太阳西落，表示时光不断流逝。古代神话中说太阳中有三足金乌，月亮中有玉兔，因以乌、兔代指日月。
东歪西倒	dong'wai'xi'dao	形容身不由己，倾斜不稳。
东完西缺	dong'wan'xi'que	谓短缺，不完备。
东望西观	dong'wang'xi'guan	同“东张西望”。
东西南北	dong'xi'nan'bei	①四方。泛指到处，处处。②指普天下。③谓飘流在外，居处无定。④指分散四方。⑤指方向。
东西南北客	dong'xi'nan'bei'ke		见“东西南北人”。
东西南北人	dong'xi'nan'bei'ren		《礼记·檀弓上》：“孔子既得合葬於防，曰：‘吾闻之，古也墓而不坟。今丘也，东西南北之人也，不可以弗识也。’於是封之，崇四尺。”郑玄注：“东西南北，言居无常处也。”后因以“东西南北人”谓居处无定之人。
东西南朔	dong'xi'nan'shuo	见“东西南北”。
东西易面	dong'xi'yi'mian	谓东西方向颠倒。汉贾谊《新书·审微》：“事之適乱，如地形之惑人也，机渐而往，俄而东西易面，人不自知也。故墨子见衢路而哭之，悲一跬而缪千里也。”后以喻是非颠倒，视听淆乱。
东徙西迁	dong'xi'xi'qian	同“东迁西徙”。
东挦西撦	dong'xian'xi'che	谓到处张罗。
东向而望，不见西墙	dong'xiang'er'wang'-'bu'jian'xi'qiang	见西墙】	《吕氏春秋·去尤》：“东面望者，不见西墙；南乡视者，不睹北方：意有所在也。”后因以“东向而望，不见西墙”比喻主观片面，顾此失彼。
东踅西倒	dong'xue'xi'dao	形容行走艰难。
东掩西遮	dong'yan'xi'zhe	谓左右遮掩，隐瞒真相。
东央西告	dong'yang'xi'gao	谓到处恳求。
东央西浼	dong'yang'xi'mei	谓到处恳求请托。
东扬西荡	dong'yang'xi'dang	谓飘泊无定。
东游西荡	dong'you'xi'dang	谓到处游荡。亦以形容不务正业。
东游西逛	dong'you'xi'guang	同“东游西荡”。
东怨西怒	dong'yuan'xi'nu	谓任意指责别人。
东张西觑	dong'zhang'xi'qu	同“东张西望”。
东张西望	dong'zhang'xi'wang	向四处张望。
东张西张	dong'zhang'xi'zhang	同“东张西望”。
东征西讨	dong'zheng'xi'tao	谓四处征伐。
东征西怨	dong'zheng'xi'yuan	语本《书·仲虺之诰》：“惟王不迩声色，不殖货利，德懋懋官，功懋懋赏……东征西夷怨，南征北狄怨。”本谓商汤向一方征伐，则另一方人民埋怨他不先来解救自己。后因以“东征西怨”谓帝王兴仁义之师为民除害，深受百姓拥戴。
东支西吾	dong'zhi'xi'wu	谓说话办事含糊敷衍。
东走西顾	dong'zou'xi'gu	谓边跑边回顾。表示念旧。
东走西撞	dong'zou'xi'zhuang	同“东奔西撞”。
东撙西节	dong'zun'xi'jie	谓从各方面节省。
冬箑夏裘	dong'sha'xia'qiu	语出《淮南子·精神训》：“知冬日之箑，夏日之裘，无用於己，则万物之变为尘埃矣。”后因以“冬箑夏裘”比喻不合时宜。
冬扇夏炉	dong'shan'xia'lu	汉王充《论衡·逢遇》：“作无益之能，纳无补之说，以夏进炉，以冬奏扇，为所不欲得之事，献所不欲闻之语，其不遇祸幸矣，何福祐之有乎。”后因以“冬扇夏炉”比喻不合时宜。
冬温夏清	dong'wen'xia'qing	见“冬温夏凊”。
冬温夏凊	dong'wen'xia'qing	①亦讹作“冬温夏清”。冬温被使暖，夏扇席使凉。谓事亲无微不至。语出《礼记·曲礼上》：“凡为人子之礼，冬温而夏凊；昏定而晨省。”②冬暖夏凉。
动地惊天	dong'di'jing'tian	惊天动地。形容令人十分震动。
动魄惊心	dong'po'jing'xin	形容使人感受很深，震动很大。
动人心魄	dong'ren'xin'po	形容使人感动或震惊。
动人心弦	dong'ren'xin'xian	形容使人十分激动。
动心忍性	dong'xin'ren'xing	《孟子·告子下》：“所以动心忍性，曾益其所不能。”赵岐注：“所以惊动其心，坚忍其性，使不违仁。”后多指不顾外界阻力，坚持下去。
动辄得咎	dong'zhe'de'jiu	谓做事往往获罪或受到责怪。咎，罪过，过失。
冻解冰释	dong'jie'bing'shi	比喻困难和障碍象冰冻融解那样消释。
冻浦鱼惊	dong'pu'yu'jing	指晋王祥卧冰求鲤事。《晋书·王祥传》：“王祥字休徵，琅邪临沂人……父母有疾，衣不解带，汤药必亲尝。母常欲生鱼，时天寒冰冻，祥解衣将剖冰求之，冰忽自解，双鲤跃出，持之而归。”后因以“冻浦鱼惊”为孝亲之典。
恫疑虚喝	dong'yi'xu'he	谓虚张声势，恐吓威胁。喝，亦写作“猲”。
恫疑虚猲	dong'yi'xu'xie	见“恫疑虚喝”。
栋朽榱崩	dong'xiu'cui'beng	犹栋折榱崩。
栋折榱崩	dong'zhe'cui'beng	正梁折断，椽子崩坏。指房屋倒塌。多比喻倾覆。
栋折榱坏	dong'zhe'cui'huai	犹栋折榱崩。比喻倾覆。
洞洞灟々	dong'dong'zhu'々	混沌无定形貌。
洞如观火	dong'ru'guan'huo	见“洞若观火”。
洞若观火	dong'ruo'guan'huo	形容观察事物非常清楚，好像看火一样。
洞天福地	dong'tian'fu'di	道教对神仙及道士所居的十大洞天、三十六小洞天、七十二福地的合称。后泛指名山胜境。
洞心骇耳	dong'xin'hai'er	形容使人震惊。
洞心骇目	dong'xin'hai'mu	形容使人惊异。
洞隐烛微	dong'yin'zhu'wei	形容目光犀利，观察事物深刻透彻。
洞幽烛微	dong'you'zhu'wei	见“洞隐烛微”。
洞幽烛远	dong'you'zhu'yuan	形容目光犀利而深远。
都头异姓	du'tou'yi'xing	谓富贵至极。
都俞吁咈	du'yu'xu'fu	《书·益稷》：“禹曰：‘都！帝，慎乃在位。’帝曰：‘俞！’”又《尧典》：“帝曰：‘吁，咈哉！’”都、俞、吁、咈均为叹词。以为可，则曰都、俞；以为否，则曰吁、咈。后因用“都俞吁咈”形容君臣论政问答，融洽雍睦。
都中纸贵	du'zhong'zhi'gui	又作：洛阳纸贵。形容别人的著作受人欢迎，广为流传。晋左思以十年时间写成《三都赋》，开始不被人赏识，后得到名士皇甫谧的赞赏，亲自为之作序，张载、刘逵为之作注释，另一名流张华也大加赞叹称扬，“於是豪贵之家竞相传写，洛阳为之纸贵”。见《晋书·文苑传·左思》。
斗脣合舌	dou'chun'he'she	又作：耍嘴皮子，卖弄口才。
斗而铸兵	dou'er'zhu'bing	见“斗而铸锥”。
斗而铸锥	dou'er'zhu'zhui	临打仗才去制造武器。比喻事到临头才想办法。
斗方名士	dou'fang'ming'shi	指自命风雅的无聊文人。
斗怪争奇	dou'guai'zheng'qi	谓以奇怪取胜。
斗鸡养狗	dou'ji'yang'gou	同“斗鸡走狗”。
斗鸡走狗	dou'ji'zou'gou	鸡与鸡相搏斗，狗与狗相竞走。古代的赌博游戏。
斗鸡走狗	dou'ji'zou'gou	见“斗鸡走狗”。
斗鸡走马	dou'ji'zou'ma	斗鸡赛马。古代的赌博游戏。
斗鸡走犬	dou'ji'zou'quan	同“斗鸡走狗”。
斗酒百篇	dou'jiu'bai'pian	饮一斗酒，作百篇诗。形容能诗善饮，文思敏捷，气概豪迈。语出唐杜甫《饮中八仙歌》：“李白一斗诗百篇，长安市上酒家眠。”
斗酒双柑	dou'jiu'shuang'gan	唐冯贽《云仙杂记·俗耳针砭诗肠鼓吹》引《高隐外书》：“戴颙春携双柑斗酒，人问何之，曰：‘往听黄鸝声。’”后因以“斗酒双柑”指春日胜游。
斗酒只鸡	dou'jiu'zhi'ji	①一斗酒一只鸡。泛指简便的酒食。②谓以鸡和酒祭奠。常用为悼亡友之辞。
斗绝一隅	dou'jue'yi'yu	孤悬边远之地；僻处边远之地。
斗丽争妍	dou'li'zheng'yan	竞相比赛艳丽。
斗量车载	dou'liang'che'zai	用斗量，用车装。形容数量很多。
斗量筲计	dou'liang'shao'ji	用斗量，用筲计。形容数量很多。
斗美讠夸丽	dou'mei'yan'kua'li		谓比赛美丽以争胜。
斗媚争妍	dou'mei'zheng'yan	竞相比赛妩媚艳丽。
斗米尺布	dou'mi'chi'bu	少量的粮、布。
斗色争妍	dou'se'zheng'yan	形容花盛开，竞相逞美。
斗霜傲雪	dou'shuang'ao'xue	形容在严酷的环境中敢于斗争，不屈不挠。
斗水活鳞	dou'shui'huo'lin	语本《庄子·外物》：“周昨来，有中道而呼者。周顾视车辙中，有鲋鱼焉。周问之曰：‘鲋鱼来！子何为者邪？’对曰：‘我，东海之波臣也。君岂有斗升之水而活我哉？’”后因以“斗水活鳞”比喻得到微薄的资助而解救眼前的危急。
斗牙拌齿	dou'ya'ban'chi	又作：斗口齿。以戏言相挑逗。斗，通“逗”。
斗艳争芳	dou'yan'zheng'fang	竞相比赛艳丽、散发芳香。
斗艳争辉	dou'yan'zheng'hui	竞相比赛美丽、焕发容光。
斗艳争妍	dou'yan'zheng'yan	见“斗艳争妍”。
斗艳争妍	dou'yan'zheng'yan	亦作“斗艳争妍”。竞相比赛艳丽。
斗挹箕扬	dou'yi'ji'yang	比喻无实用。斗、箕皆星宿名，一象斗，一象箕，故以为名。语出《诗·小雅·大东》：“维南有箕，不可以簸扬；维北有斗，不可以挹酒浆。”孔颖达疏：“言维此天上，其南则有箕星，不可以簸扬米粟；维此天上，其北则有斗星，不可以挹Ｕ其酒浆。”
斗折蛇行	dou'zhe'she'xing	形容道路、河流等曲折蜿蜒。
斗志昂扬	dou'zhi'ang'yang	斗争意志高昂。
斗转参横	dou'zhuan'can'heng	北斗转向，参星横斜。表示天色将明。
豆分瓜剖	dou'fen'gua'pou	见“豆剖瓜分”。
豆蔻年华	dou'kou'nian'hua	指少女的青春年华。
豆剖瓜分	dou'pou'gua'fen	亦作“豆分瓜剖”。语出《晋书·地理志序》：“平王东迁，星离豆剖；当涂驭敚瓜分鼎立。”后以喻疆土分裂。
豆萁燃豆	dou'qi'ran'dou	三国魏曹植《七步诗》：“煮豆燃豆萁，豆在釜中泣。本是同根生，相煎何太急。”后以“豆萁燃豆”喻兄弟相残。
豆萁相煎	dou'qi'xiang'jian	同“豆萁燃豆”。
毒赋賸敛	du'fu'sheng'lian	横征暴敛。
毒泷恶雾	du'long'e'wu	恶劣的云雨雾气。比喻暴虐凶残的黑暗势力。
毒魔狠怪	du'mo'hen'guai	凶恶残忍的妖魔鬼怪。
毒蛇猛兽	du'she'meng'shou	①泛指对人类生命有威胁的动物。②比喻贪暴者。
读书君子	du'shu'jun'zi	旧时称有志操有学问的人。
读书种子	du'shu'zhong'zi	读书人，能读书做学问的人。
犊牧采薪	du'mu'cai'xin	喻指老而无妻的人。
黩武穷兵	du'wu'qiong'bing	滥用兵力，任意征讨。
独辟蹊径	du'bi'xi'jing	独自开辟一条新路。比喻独创一种新方法。
独出心裁	du'chu'xin'cai	原指诗文构思独到，别创一格。后亦泛指想出的办法与众不同。
独出新裁	du'chu'xin'cai	犹独出心裁。
独胆英雄	du'dan'ying'xiong	指不畏强敌，英勇奋战，以少胜多的杰出人物。
独当一面	du'dang'yi'mian	①单独担当一个部门或一个方面的重任。语出《史记·留侯世家》：“良进曰：‘……汉王之将独韩信可属大事，当一面。’”②特指单独迎战一面之敌。
独断独行	du'duan'du'xing	只凭自己意志行事，不考虑他人的意见。
独断专行	du'duan'zhuan'xing	同“独断独行”。
独夫民贼	du'fu'min'zei	谓祸国殃民、众叛亲离的统治者。
独鹤鸡群	du'he'ji'qun	犹鹤立鸡群。比喻一个人才能或仪表出众。
独茧抽丝	du'jian'chou'si	①喻诗文条理分明，脉络清晰。②喻单方思慕。
独具匠心	du'ju'jiang'xin	具有独到的灵巧心思或创造性。
独具只眼	du'ju'zhi'yan	“只眼”原指大自在天神（Mahe裿ara）的顶门眼，竖起双眉之上，功能卓异。见《大智度论》卷二。禅宗用其典，指别具能够“见性”之“眼”。语本《景德传灯录·普愿禅师》：“师拈起球子，问僧云：‘那个何似遮个？’对云：‘不似。’……师云：‘许你具一只眼。’”亦泛指具有别人没有的眼光和见解。
独来独往	du'lai'du'wang	独身来往，不与人为伍。亦比喻事事不与人同。
独立王国	du'li'wang'guo	原指主权完整的君主制国家。现用以比喻一个地区、单位或组织，不受上级或其他任何约束，自行其是者。
独立自主	du'li'zi'zhu	不依赖别人，也不受别人的支配或控制，按自己的主张和权利行事。
独木不成林	du'mu'bu'cheng'lin		比喻个人力量有限，做不成大事。
独木难支	du'mu'nan'zhi	谓一根木头支持不住高大的房屋。比喻个人力量不能维持全局。
独善其身	du'shan'qi'shen	本指注重自身修养，保持节操。后亦指怕招惹是非，只顾自己好，不关心身外事。
独善吾身	du'shan'wu'shen	同“独善其身”。
独善一身	du'shan'yi'shen	同“独善其身”。
独是独非	du'shi'du'fei	谓不采众议，凡事独断。
独树一帜	du'shu'yi'zhi	单独树立一面旗帜。比喻与众不同，自成一家。
独竖一帜	du'shu'yi'zhi	同“独树一帜”。
独往独来	du'wang'du'lai	①指特立独行的人，摆脱万物的挂碍，自由往来于天地间。②指人之思想、行为、活动自由，无所阻碍。③一人自去自来。④指文章能推陈出新，独树一帜。
独行独断	du'xing'du'duan	同“独断独行”。
独行踽踽	du'xing'ju'ju	孤零零地一个人走路。
独行其是	du'xing'qi'shi	只顾按自己的主张去做。
独一无二	du'yi'wu'er	没有相同的；没有可与相比的；唯一的。
独占鰲头	du'zhan'ao'tou	科举时代称中状元。据说皇宫石阶前刻有鰲（大鳖）的头，状元及第时站此迎榜。后来比喻占首位或居第一名。
独占鼇头	du'zhan'ao'tou	见“独占鰲头”。
笃定泰山	du'ding'tai'shan	像泰山那样稳定。比喻有绝对把握，无须忧虑。
笃而论之	du'er'lun'zhi	确切地评述。
笃论高言	du'lun'gao'yan	确切高明的言论。
笃实好学	du'shi'hao'xue	认真踏实，爱好学问。
笃新怠旧	du'xin'dai'jiu	又作：喜新厌旧。
笃信好学	du'xin'hao'xue	谓对道德和事业抱有坚定的信心，并勤奋学习。
笃学不倦	du'xue'bu'juan	专心学习，不知疲倦。
笃志好学	du'zhi'hao'xue	志趣专一，爱好学问。
赌彩一掷	du'cai'yi'zhi	又作：孤注一掷。
赌长较短	du'chang'jiao'duan	谓比优劣。
赌神发咒	du'shen'fa'zhou	又作：对天发誓。
赌誓发原	du'shi'fa'yuan	又作：赌咒发誓。
赌咒发誓	du'zhou'fa'shi	庄严地说出表示决心的话或对某事提出保证。
睹始知终	du'shi'zhi'zhong	谓看见事物的开始阶段就预见到它的最终结果。
睹微知著	du'wei'zhi'zhu	看到事物的细微迹兆，就可认识其实质和发展。
睹物思人	du'wu'si'ren	看到他人留下的东西或死者的遗物，就想起这个人。
睹著知微	du'zhu'zhi'wei	从明显的表象，推知到隐微的内情。
妒贤疾能	du'xian'ji'neng	见“妒贤嫉能”。
妒贤嫉能	du'xian'ji'neng	妒忌才德胜于己的人。
杜弊清源	du'bi'qing'yuan	杜绝弊端，廓清来源。
杜断房谋	du'duan'fang'mou	《新唐书·杜如晦传》：“每议事帝所，玄龄必曰：‘非如晦莫筹之。’及如晦至，卒用玄龄策也。盖如晦长於断，而玄龄善谋，两人深相知，故能同心济谋，以佐佑帝。”后因以谓多谋善断曰“杜断房谋”。
杜耳恶闻	du'er'e'wen	塞住耳朵不愿听。
杜渐除微	du'jian'chu'wei	同“杜渐防萌”。
杜渐防萌	du'jian'fang'meng	杜绝乱源的开端，防备祸患的萌芽。把隐患消除在开端与萌芽状态中。即防患于未然。
杜渐防微	du'jian'fang'wei	同“杜渐防萌”。
杜口裹足	du'kou'guo'zu	闭口不言，停足不前。形容十分害怕。
杜口结舌	du'kou'jie'she	又作：杜口吞声。
杜口绝言	du'kou'jue'yan	又作：杜口无言。
杜口吞声	du'kou'tun'sheng	闭口不敢作声。形容极度害怕。
杜口无言	du'kou'wu'yan	闭住嘴巴，不出一言。
杜门不出	du'men'bu'chu	关闭门户，不外出与人交往接触。
杜门绝迹	du'men'jue'ji	谓隐居不出。
杜门绝客	du'men'jue'ke	同“杜门谢客”。
杜门面壁	du'men'mian'bi	谓闭门修养。
杜门屏迹	du'men'ping'ji	见“杜门晦迹”。
杜门却扫	du'men'que'sao	关闭大门，不再打扫庭院路径。意谓屏居谢客，清静自适。
杜门谢客	du'men'xie'ke	谓闭门不与外界交往。
杜门自绝	du'men'zi'jue	关闭大门，将自己与外界隔绝。
杜门自守	du'men'zi'shou	谓居家守其本分。
杜隙防微	du'xi'fang'wei	同“杜渐防萌”。
度长絜大	du'chang'xie'da	谓比量长短大小。
度长絜短	du'chang'xie'duan	见“度长絜大”。
度德量力	du'de'liang'li	估量自己的德行和能力。语出《左传·隐公十一年》：“度德而处之，量力而行之。”
度日如年	du'ri'ru'nian	过一天象过一年那样长。形容困苦的日子长久难熬。
度日如岁	du'ri'ru'sui	同“度日如年”。
蠹国病民	du'guo'bing'min	同“蠹国害民”。
蠹国残民	du'guo'can'min	同“蠹国害民”。
蠹国害民	du'guo'hai'min	危害国家和人民。
蠹国耗民	du'guo'hao'min	同“蠹国害民”。
蠹国嚼民	du'guo'jiao'min	同“蠹国害民”。
蠹简遗编	du'jian'yi'bian	泛指残存的书籍。
蠹居棋处	du'ju'qi'chu	如虫深居，如棋密布。喻坏人隐蔽很深，散布很广。
蠹民梗政	du'min'geng'zheng	侵害人民，阻挠政令。
蠹政病民	du'zheng'bing'min	同“蠹国害民”。
蠹政害民	du'zheng'hai'min	同“蠹国害民”。
端本澄源	duan'ben'cheng'yuan	又作：正本清源。从根本上加以整顿清理。
端人正士	duan'ren'zheng'shi	端庄正直的人。
短兵相接	duan'bing'xiang'jie	①敌我逼近，用短兵器交战。②比喻面对面的激烈斗争。
短吃少穿	duan'chi'shao'chuan	谓衣食困乏。
短刀直入	duan'dao'zhi'ru	比喻开门见山，直截爽快。
短绠汲深	duan'geng'ji'shen	《庄子·至乐》：“褚小者不可以怀大，绠短者不可以汲深。”郭象注：“绠，汲索也。”后以“短绠汲深”比喻才力不称。
短褐不全	duan'he'bu'quan	见“短褐不完”。
短褐不完	duan'he'bu'wan	连粗布短衣也穿不周全。形容生活穷苦。
短见薄识	duan'jian'bao'shi	见识浅短。
短寿促命	duan'shou'cu'ming	短命早死；要命。
短叹长吁	duan'tan'chang'xu	不停地叹气。
短小精悍	duan'xiao'jing'han	①身材短小而精明强干。②形容文章、言论等简短有力。
短吁长叹	duan'xu'chang'tan	见“短叹长吁”。
短中取长	duan'zhong'qu'chang	谓于一般中选择比较好的。
断壁残垣	duan'bi'can'yuan	见“断壁颓垣”。
断壁颓垣	duan'bi'tui'yuan	倒塌了的墙壁。形容残破的景象。
断编残简	duan'bian'can'jian	残缺不全的古籍。简，古时用以书写的竹片。编，穿简的皮条。
断长补短	duan'chang'bu'duan	又作：截长补短。截取有馀以补不足。
断长续短	duan'chang'xu'duan	断长补短。
断脰决腹	duan'dou'jue'fu	砍头剖腹。形容死之壮烈。
断发文身	duan'fa'wen'shen	古代吴越一带风俗，截短头发，身刺花纹，以避水中蛟龙之害。
断发纹身	duan'fa'wen'shen	见“断发文身”。
断梗飞蓬	duan'geng'fei'peng	见“断梗飘蓬”。
断梗浮萍	duan'geng'fu'ping	比喻漂泊不定。
断梗飘蓬	duan'geng'piao'peng	比喻漂泊不定。
断梗飘萍	duan'geng'piao'ping	见“断梗浮萍”。
断怪除妖	duan'guai'chu'yao	谓铲除妖魔鬼怪。
断管残瀋	duan'guan'can'shen	残缺不全的字画。管，笔；瀋，墨汁。
断圭碎璧	duan'gui'sui'bi	亦作“断珪缺璧”。喻指片段而珍贵的文字。
断珪缺璧	duan'gui'que'bi	见“断圭碎璧”。
断鹤续凫	duan'he'xu'fu	截下鹤的长腿接到野鸭的短腿上。比喻强做违反规律的事。语本《庄子·骈拇》：“长者不为有馀，短者不为不足。是故凫胫虽短，续之则忧，鹤胫虽长，断之则悲。”
断齑画粥	duan'ji'hua'zhou	形容贫苦力学。典出《五朝名臣言行录·参政范文正公》“公生二岁而孤”原注引宋魏泰《东轩笔录》：“公（范仲淹）少与刘某上长白僧舍脩学，惟煮粟米二升，作粥一器，经宿遂凝，以刀画为四塊，早晚取二塊，断齑数十茎，……入少盐，暖而啗之。如此者三年。”
断齑塊粥	duan'ji'kuai'zhou	见“断齑画粥”。
断缣尺楮	duan'jian'chi'chu	又作：断缣寸纸。
断缣寸纸	duan'jian'cun'zhi	残缺不全的书画。
断缣零璧	duan'jian'ling'bi	比喻片段而珍贵的文字。
断简残编	duan'jian'can'bian	又作：断编残简。
断蛟刺虎	duan'jiao'ci'hu	相传晋周处曾射蛟杀虎，为民除害。事见南朝宋刘义庆《世说新语·自新》。后以“断蛟刺虎”谓武艺高强，行为侠义。
断金零粉	duan'jin'ling'fen	断折的花钿和零散的铅粉。借指因遭横逆而结局不圆满的风流韵事。
断井颓垣	duan'jing'tui'yuan	断了的井栏，倒塌的短墙。形容荒凉破败的景象。
断决如流	duan'jue'ru'liu	见“断决如流”。
断决如流	duan'jue'ru'liu	处理事务果断，多而快。
断决如流	duan'jue'ru'liu	处理事务果断，多而快。
断烂朝报	duan'lan'zhao'bao	①宋王安石对《春秋》经的贬称。王安石以《春秋》多残缺，而解经者每遇疑难之处，即指为阙文，故云。断烂，残缺不全。朝报，政府的公告。②谓事实记载凌乱芜杂。
断墨残楮	duan'mo'can'chu	指残缺不全的典籍。楮，纸。
断木掘地	duan'mu'jue'di	上古时代，断木为杵，掘地为臼。虽粗拙，亦适用。语出《易·系辞下》。
断头将军	duan'tou'jiang'jun	坚决抵抗、宁死不屈的将军。典出《三国志·蜀志·张飞传》：“至江州，破璋将巴郡太守严颜，生获颜。飞呵颜曰：‘大军至，何以不降而敢拒战？’颜答曰：‘卿等无状，侵夺我州，我州但有断头将军，无有降将军也。’”
断线风筝	duan'xian'feng'zheng	见“断线风筝”。
断线风筝	duan'xian'feng'zheng	比喻一去不返的人或事物。
断线鹞子	duan'xian'yao'zi	又作：断线风筝。鹞子，指纸鸢，鸟形风筝。
断香零玉	duan'xiang'ling'yu	比喻女子的尸骸。
断羽绝鳞	duan'yu'jue'lin	断绝书信。羽鳞，犹鱼雁。
断雨残云	duan'yu'can'yun	比喻男女恩爱中绝，欢情未能持续。
断垣残壁	duan'yuan'can'bi	倒塌了的墙壁。形容残破的景象。
断章截句	duan'zhang'jie'ju	截取诗文的一章一句。
断章取义	duan'zhang'qu'yi	亦作“断章取意”。谓引用别人的诗文或谈话，只截取其片断而不顾全文和原意。
断章取意	duan'zhang'qu'yi	见“断章取义”。
断章摘句	duan'zhang'zhai'ju	裁断章节，选用文句。
断纸馀墨	duan'zhi'yu'mo	零星或残存的墨迹。
断子绝孙	duan'zi'jue'sun	①无后代，断绝后代。②詈词。
堆积如山	dui'ji'ru'shan	积聚成堆，如同小山。形容极多。
堆金积玉	dui'jin'ji'yu	形容财富充裕。
堆山积海	dui'shan'ji'hai	形容东西极多。
对床风雨	dui'chuang'feng'yu	同“对床夜雨”。
对床夜雨	dui'chuang'ye'yu	风雨之夜，两人对床而眠。喻亲友相聚的欢悦。
对床夜语	dui'chuang'ye'yu	两人夜间对床共语。
对答如流	dui'da'ru'liu	答话敏捷顺暢，象流水一样。形容口才好。
对景挂画	dui'jing'gua'hua	比喻两相切合。
对客挥毫	dui'ke'hui'hao	喻文思敏捷。毫，毛笔。
对牛弹琴	dui'niu'dan'qin	亦作“对牛鼓簧”。喻对不懂事理的人讲道理或言事。常含有徒劳无功或讽刺对方愚蠢之意。语本汉牟融《理惑论》：“公明仪为牛弹清角之操，伏食如故，非牛不闻，不合其耳矣。”
对牛鼓簧	dui'niu'gu'huang	见“对牛弹琴”。
对头冤家	dui'tou'yuan'jia	仇人。
对证下药	dui'zheng'xia'yao	见“对症下药”。
对症发药	dui'zheng'fa'yao	同“对症下药”。
对症下药	dui'zheng'xia'yao	亦作“对证下药”。针对病症用药。比喻针对问题，确定解决的办法。
敦本务实	dun'ben'wu'shi	崇尚根本，注重实际。
